GEOID,SUMLEVEL,ST,COUNTY,B22002_001E,B22002_002E,B22002_003E,B22002_004E,B22002_005E,B22002_006E,B22002_007E,B22002_008E,B22002_009E,B22002_010E,B22002_011E,B22002_012E,B22002_013E,B22002_014E,B22002_015E,B22002_016E,B22002_017E,B22002_018E,B22002_019E,B22002_020E,B22002_021E,B22002_022E,B22002_023E,B22002_024E,B22002_025E,B22002_026E,B22002_027E,COMPONENT,TRACT
04000US06,40,6,null,12542460,1012610,752421,307669,437271,86714,350557,7481,260189,56344,76791,21388,55403,127054,11529850,3861307,2777616,1056103,329474,726629,27588,7668543,3026622,865406,305245,560161,3776515,0,null
05000US06037,50,6,37,3230383,251947,191186,74816,114902,22107,92795,1468,60761,12773,19323,4970,14353,28665,2978436,989581,673216,310173,93329,216844,6192,1988855,684754,280674,99382,181292,1023427,0,null
14000US06037101110,140,6,37,1682,81,66,56,10,10,0,0,15,7,8,0,8,0,1601,516,375,141,55,86,0,1085,512,115,37,78,458,0,101110
14000US06037101122,140,6,37,1228,27,20,13,7,0,7,0,7,0,7,0,7,0,1201,358,300,58,0,58,0,843,491,78,16,62,274,0,101122
14000US06037101210,140,6,37,2216,199,147,80,67,0,67,0,52,22,0,0,0,30,2017,635,353,282,107,175,0,1382,383,284,85,199,715,0,101210
14000US06037101220,140,6,37,1167,73,50,21,29,11,18,0,23,0,0,0,0,23,1094,315,176,139,30,109,0,779,302,101,16,85,376,0,101220
14000US06037101300,140,6,37,1529,5,5,0,5,5,0,0,0,0,0,0,0,0,1524,430,419,11,0,11,0,1094,550,127,102,25,417,0,101300
14000US06037101400,140,6,37,1534,117,59,5,54,3,51,0,58,8,50,0,50,0,1417,321,224,85,7,78,12,1096,474,198,71,127,424,0,101400
14000US06037102103,140,6,37,680,8,0,0,0,0,0,0,8,8,0,0,0,0,672,152,137,15,7,8,0,520,157,90,51,39,273,0,102103
14000US06037102104,140,6,37,1310,0,0,0,0,0,0,0,0,0,0,0,0,0,1310,211,179,25,11,14,7,1099,485,142,51,91,472,0,102104
14000US06037102105,140,6,37,570,30,24,24,0,0,0,0,6,0,6,6,0,0,540,190,155,35,0,35,0,350,119,55,20,35,176,0,102105
14000US06037102107,140,6,37,1216,148,59,4,55,0,55,0,89,24,65,0,65,0,1068,290,124,156,51,105,10,778,312,101,71,30,365,0,102107
14000US06037103101,140,6,37,904,38,33,4,29,13,16,0,5,0,5,0,5,0,866,257,244,13,13,0,0,609,303,38,1,37,268,0,103101
14000US06037103102,140,6,37,1661,101,92,27,65,47,18,0,9,0,0,0,0,9,1560,478,342,136,10,126,0,1082,477,83,28,55,522,0,103102
14000US06037103200,140,6,37,2169,43,43,0,43,32,11,0,0,0,0,0,0,0,2126,487,305,182,95,87,0,1639,530,204,102,102,905,0,103200
14000US06037103300,140,6,37,1280,13,13,0,13,0,13,0,0,0,0,0,0,0,1267,205,161,44,0,44,0,1062,493,116,49,67,453,0,103300
14000US06037103400,140,6,37,2434,231,64,30,34,34,0,0,167,98,0,0,0,69,2203,593,508,85,56,29,0,1610,634,212,38,174,764,0,103400
14000US06037104103,140,6,37,768,43,24,21,3,0,3,0,19,19,0,0,0,0,725,406,283,123,61,62,0,319,131,91,28,63,97,0,104103
14000US06037104105,140,6,37,1434,237,210,58,152,0,152,0,27,0,27,16,11,0,1197,735,368,322,65,257,45,462,204,165,73,92,93,0,104105
14000US06037104108,140,6,37,1355,170,147,69,69,25,44,9,23,23,0,0,0,0,1185,521,238,283,113,170,0,664,188,99,13,86,377,0,104108
14000US06037104124,140,6,37,1185,132,82,63,19,6,13,0,50,7,5,5,0,38,1053,315,291,24,0,24,0,738,424,57,27,30,257,0,104124
14000US06037104201,140,6,37,881,163,146,77,69,0,69,0,17,11,6,0,6,0,718,362,264,98,34,64,0,356,137,148,58,90,71,0,104201
14000US06037104203,140,6,37,1011,99,89,67,22,0,22,0,10,0,10,10,0,0,912,476,318,158,55,103,0,436,150,85,50,35,201,0,104203
14000US06037104204,140,6,37,714,118,106,77,29,0,29,0,12,0,11,0,11,1,596,321,234,87,22,65,0,275,81,88,52,36,106,0,104204
14000US06037104310,140,6,37,840,113,89,39,50,22,28,0,24,19,5,0,5,0,727,381,230,146,60,86,5,346,199,114,42,72,33,0,104310
14000US06037104320,140,6,37,1122,205,149,64,85,59,26,0,56,20,0,0,0,36,917,415,341,74,0,74,0,502,203,114,63,51,185,0,104320
14000US06037104401,140,6,37,625,101,78,47,31,0,31,0,23,23,0,0,0,0,524,398,294,104,68,36,0,126,63,24,10,14,39,0,104401
14000US06037104403,140,6,37,616,52,47,41,6,6,0,0,5,0,5,0,5,0,564,327,183,144,57,87,0,237,119,62,29,33,56,0,104403
14000US06037104404,140,6,37,595,63,55,20,35,17,18,0,8,8,0,0,0,0,532,321,174,147,13,134,0,211,104,48,17,31,59,0,104404
14000US06037104500,140,6,37,654,83,73,31,35,0,35,7,10,5,5,5,0,0,571,361,216,145,33,112,0,210,79,11,11,0,120,0,104500
14000US06037104610,140,6,37,733,125,109,69,40,0,40,0,16,16,0,0,0,0,608,370,237,133,47,86,0,238,109,83,27,56,46,0,104610
14000US06037104620,140,6,37,736,74,60,30,30,0,30,0,14,12,2,0,2,0,662,354,280,74,5,69,0,308,160,102,23,79,46,0,104620
14000US06037104701,140,6,37,873,318,264,96,168,0,168,0,54,27,7,0,7,20,555,380,209,171,62,109,0,175,47,97,9,88,31,0,104701
14000US06037104703,140,6,37,511,82,51,12,39,0,39,0,31,0,0,0,0,31,429,235,142,93,35,58,0,194,99,43,43,0,52,0,104703
14000US06037104704,140,6,37,1114,120,95,42,53,3,50,0,25,18,0,0,0,7,994,552,368,184,47,137,0,442,149,128,67,61,165,0,104704
14000US06037104810,140,6,37,1035,208,208,63,145,80,65,0,0,0,0,0,0,0,827,465,230,235,106,129,0,362,191,134,33,101,37,0,104810
14000US06037104821,140,6,37,745,77,51,33,18,12,6,0,26,12,14,0,14,0,668,351,232,119,12,107,0,317,164,57,50,7,96,0,104821
14000US06037104822,140,6,37,517,112,104,82,22,0,22,0,8,0,0,0,0,8,405,176,131,45,15,30,0,229,29,51,22,29,149,0,104822
14000US06037106010,140,6,37,861,51,51,34,12,12,0,5,0,0,0,0,0,0,810,290,156,134,37,97,0,520,293,60,53,7,167,0,106010
14000US06037106020,140,6,37,1346,50,41,10,31,0,31,0,9,0,0,0,0,9,1296,608,443,139,54,85,26,688,446,111,34,77,131,0,106020
14000US06037106111,140,6,37,1394,38,32,0,32,0,32,0,6,6,0,0,0,0,1356,582,479,103,21,82,0,774,336,109,8,101,329,0,106111
14000US06037106112,140,6,37,1483,19,19,19,0,0,0,0,0,0,0,0,0,0,1464,749,595,154,28,126,0,715,347,161,8,153,207,0,106112
14000US06037106113,140,6,37,921,52,52,26,0,0,0,26,0,0,0,0,0,0,869,478,326,152,29,123,0,391,224,87,15,72,80,0,106113
14000US06037106114,140,6,37,1515,161,136,23,113,22,91,0,25,0,13,0,13,12,1354,715,340,375,57,318,0,639,229,192,43,149,218,0,106114
14000US06037106403,140,6,37,697,96,91,75,16,0,16,0,5,0,0,0,0,5,601,249,205,44,16,28,0,352,187,61,5,56,104,0,106403
14000US06037106405,140,6,37,955,29,29,16,13,0,13,0,0,0,0,0,0,0,926,379,232,147,38,109,0,547,292,94,0,94,161,0,106405
14000US06037106406,140,6,37,1379,99,70,20,50,0,50,0,29,22,7,0,7,0,1280,513,462,51,0,51,0,767,336,166,60,106,265,0,106406
14000US06037106407,140,6,37,760,82,76,6,70,0,70,0,6,0,0,0,0,6,678,307,130,177,0,177,0,371,117,65,16,49,189,0,106407
14000US06037106408,140,6,37,965,174,140,38,94,0,94,8,34,15,10,0,10,9,791,481,279,202,116,86,0,310,69,96,0,96,145,0,106408
14000US06037106510,140,6,37,1489,30,15,0,15,15,0,0,15,0,15,15,0,0,1459,495,368,127,0,127,0,964,439,85,39,46,440,0,106510
14000US06037106520,140,6,37,1278,69,38,0,38,7,31,0,31,0,21,7,14,10,1209,507,414,93,5,88,0,702,374,101,35,66,227,0,106520
14000US06037106603,140,6,37,1005,0,0,0,0,0,0,0,0,0,0,0,0,0,1005,441,349,92,50,42,0,564,391,50,13,37,123,0,106603
14000US06037106604,140,6,37,1157,106,96,42,54,18,36,0,10,10,0,0,0,0,1051,588,287,301,82,219,0,463,185,99,20,79,179,0,106604
14000US06037106641,140,6,37,733,4,4,0,4,0,4,0,0,0,0,0,0,0,729,232,207,25,9,16,0,497,366,39,15,24,92,0,106641
14000US06037106642,140,6,37,1117,51,48,0,48,0,48,0,3,3,0,0,0,0,1066,359,308,51,33,18,0,707,407,132,22,110,168,0,106642
14000US06037106643,140,6,37,1310,0,0,0,0,0,0,0,0,0,0,0,0,0,1310,459,377,82,32,50,0,851,616,68,9,59,167,0,106643
14000US06037106645,140,6,37,1166,22,0,0,0,0,0,0,22,9,13,13,0,0,1144,430,396,34,0,34,0,714,516,35,8,27,163,0,106645
14000US06037106646,140,6,37,985,11,5,0,5,5,0,0,6,6,0,0,0,0,974,412,297,115,23,92,0,562,335,66,0,66,161,0,106646
14000US06037106648,140,6,37,955,235,235,67,168,66,102,0,0,0,0,0,0,0,720,370,242,128,24,104,0,350,148,129,44,85,73,0,106648
14000US06037106649,140,6,37,666,57,9,0,9,0,9,0,48,27,21,0,21,0,609,277,248,29,29,0,0,332,173,82,14,68,77,0,106649
14000US06037107010,140,6,37,732,58,44,30,14,0,14,0,14,0,14,0,14,0,674,354,304,50,25,25,0,320,97,108,78,30,115,0,107010
14000US06037107020,140,6,37,1218,123,105,10,95,0,95,0,18,18,0,0,0,0,1095,629,483,146,63,83,0,466,264,105,29,76,97,0,107020
14000US06037108101,140,6,37,800,0,0,0,0,0,0,0,0,0,0,0,0,0,800,197,171,26,0,26,0,603,357,56,37,19,190,0,108101
14000US06037108102,140,6,37,1250,3,0,0,0,0,0,0,3,0,0,0,0,3,1247,396,311,85,25,60,0,851,558,117,26,91,176,0,108102
14000US06037108103,140,6,37,1062,6,6,6,0,0,0,0,0,0,0,0,0,0,1056,297,256,41,0,41,0,759,525,135,87,48,99,0,108103
14000US06037108104,140,6,37,593,0,0,0,0,0,0,0,0,0,0,0,0,0,593,264,240,24,2,22,0,329,275,7,0,7,47,0,108104
14000US06037108201,140,6,37,1914,7,0,0,0,0,0,0,7,7,0,0,0,0,1907,815,624,191,31,160,0,1092,592,153,50,103,347,0,108201
14000US06037108202,140,6,37,1982,30,30,30,0,0,0,0,0,0,0,0,0,0,1952,749,647,102,25,77,0,1203,665,73,31,42,465,0,108202
14000US06037109100,140,6,37,690,17,12,12,0,0,0,0,5,0,5,5,0,0,673,176,144,32,0,32,0,497,177,76,35,41,244,0,109100
14000US06037109200,140,6,37,923,18,4,4,0,0,0,0,14,0,14,14,0,0,905,374,324,50,15,35,0,531,183,110,50,60,238,0,109200
14000US06037109300,140,6,37,878,19,6,0,6,0,6,0,13,0,7,0,7,6,859,377,217,160,75,85,0,482,240,98,10,88,144,0,109300
14000US06037109400,140,6,37,1088,34,18,18,0,0,0,0,16,0,8,0,8,8,1054,458,337,121,0,121,0,596,231,175,83,92,190,0,109400
14000US06037109500,140,6,37,1042,41,41,17,24,5,19,0,0,0,0,0,0,0,1001,559,325,219,76,143,15,442,197,82,5,77,163,0,109500
14000US06037109601,140,6,37,1272,17,8,0,8,8,0,0,9,0,0,0,0,9,1255,563,396,167,82,85,0,692,283,257,37,220,152,0,109601
14000US06037109603,140,6,37,1277,56,47,23,24,7,17,0,9,9,0,0,0,0,1221,446,250,196,56,140,0,775,180,250,117,133,345,0,109603
14000US06037109604,140,6,37,934,22,18,7,11,0,11,0,4,0,0,0,0,4,912,300,199,101,11,90,0,612,273,115,33,82,224,0,109604
14000US06037109700,140,6,37,1305,53,43,36,7,0,7,0,10,0,0,0,0,10,1252,487,380,107,54,53,0,765,365,59,17,42,341,0,109700
14000US06037109800,140,6,37,1390,60,37,37,0,0,0,0,23,0,9,9,0,14,1330,416,276,140,7,133,0,914,387,133,55,78,394,0,109800
14000US06037111100,140,6,37,964,17,4,4,0,0,0,0,13,0,0,0,0,13,947,366,326,40,0,40,0,581,261,143,68,75,177,0,111100
14000US06037111201,140,6,37,1049,25,7,7,0,0,0,0,18,0,18,7,11,0,1024,310,252,58,0,58,0,714,484,75,43,32,155,0,111201
14000US06037111202,140,6,37,1820,47,24,12,12,0,12,0,23,13,0,0,0,10,1773,703,463,240,86,154,0,1070,374,218,143,75,478,0,111202
14000US06037111204,140,6,37,1906,15,0,0,0,0,0,0,15,8,7,7,0,0,1891,736,594,142,82,60,0,1155,762,149,35,114,244,0,111204
14000US06037111205,140,6,37,1305,47,10,0,10,0,10,0,37,0,14,14,0,23,1258,446,320,126,0,126,0,812,394,141,16,125,277,0,111205
14000US06037111206,140,6,37,1443,15,8,8,0,0,0,0,7,0,7,0,7,0,1428,471,410,61,0,61,0,957,593,98,33,65,266,0,111206
14000US06037111301,140,6,37,2687,191,83,44,39,0,39,0,108,43,65,0,65,0,2496,776,547,229,53,176,0,1720,516,320,129,191,884,0,111301
14000US06037111302,140,6,37,1775,45,38,26,12,0,12,0,7,0,7,0,7,0,1730,426,263,163,42,121,0,1304,399,196,64,132,709,0,111302
14000US06037111400,140,6,37,2781,150,35,0,35,16,19,0,115,0,82,0,82,33,2631,1023,767,256,39,217,0,1608,614,278,16,262,716,0,111400
14000US06037113101,140,6,37,1155,13,0,0,0,0,0,0,13,13,0,0,0,0,1142,336,304,32,11,21,0,806,461,164,33,131,181,0,113101
14000US06037113102,140,6,37,952,0,0,0,0,0,0,0,0,0,0,0,0,0,952,301,238,63,9,54,0,651,456,59,8,51,136,0,113102
14000US06037113211,140,6,37,1568,10,0,0,0,0,0,0,10,10,0,0,0,0,1558,361,297,64,0,64,0,1197,587,143,43,100,467,0,113211
14000US06037113212,140,6,37,1068,14,0,0,0,0,0,0,14,14,0,0,0,0,1054,344,247,97,17,80,0,710,337,54,11,43,319,0,113212
14000US06037113213,140,6,37,1656,65,56,7,49,0,49,0,9,0,0,0,0,9,1591,491,312,179,43,136,0,1100,515,116,53,63,469,0,113213
14000US06037113231,140,6,37,825,0,0,0,0,0,0,0,0,0,0,0,0,0,825,252,195,57,0,57,0,573,269,44,34,10,260,0,113231
14000US06037113232,140,6,37,1391,23,23,0,23,0,23,0,0,0,0,0,0,0,1368,406,367,39,0,39,0,962,516,143,8,135,303,0,113232
14000US06037113233,140,6,37,2247,296,238,45,193,26,167,0,58,0,0,0,0,58,1951,825,430,395,94,301,0,1126,237,165,70,95,724,0,113233
14000US06037113234,140,6,37,1401,192,152,46,106,30,76,0,40,21,10,0,10,9,1209,482,269,213,71,142,0,727,294,121,0,121,312,0,113234
14000US06037113235,140,6,37,678,40,16,0,16,0,16,0,24,0,24,19,5,0,638,161,139,22,0,22,0,477,189,89,20,69,199,0,113235
14000US06037113237,140,6,37,1407,45,27,27,0,0,0,0,18,10,8,0,8,0,1362,353,304,49,31,18,0,1009,408,137,31,106,464,0,113237
14000US06037113301,140,6,37,766,15,15,9,6,6,0,0,0,0,0,0,0,0,751,230,174,56,0,56,0,521,264,95,43,52,162,0,113301
14000US06037113303,140,6,37,1348,69,45,45,0,0,0,0,24,14,10,0,10,0,1279,530,358,172,19,153,0,749,461,114,15,99,174,0,113303
14000US06037113321,140,6,37,2353,64,31,10,21,0,21,0,33,0,0,0,0,33,2289,674,368,266,30,236,40,1615,475,213,98,115,927,0,113321
14000US06037113322,140,6,37,1363,33,0,0,0,0,0,0,33,26,7,0,7,0,1330,478,353,125,43,82,0,852,462,70,15,55,320,0,113322
14000US06037113401,140,6,37,1712,63,45,12,33,33,0,0,18,0,0,0,0,18,1649,462,248,214,79,135,0,1187,484,191,76,115,512,0,113401
14000US06037113421,140,6,37,1897,197,177,49,128,0,128,0,20,0,10,0,10,10,1700,783,448,335,129,206,0,917,366,93,22,71,458,0,113421
14000US06037113422,140,6,37,2098,156,145,81,64,13,51,0,11,11,0,0,0,0,1942,712,472,240,27,213,0,1230,539,61,0,61,630,0,113422
14000US06037115101,140,6,37,1678,22,22,22,0,0,0,0,0,0,0,0,0,0,1656,560,443,117,39,78,0,1096,724,62,26,36,310,0,115101
14000US06037115103,140,6,37,55,13,13,13,0,0,0,0,0,0,0,0,0,0,42,13,13,0,0,0,0,29,12,0,0,0,17,0,115103
14000US06037115104,140,6,37,1794,11,0,0,0,0,0,0,11,0,0,0,0,11,1783,294,142,145,0,145,7,1489,326,66,18,48,1097,0,115104
14000US06037115201,140,6,37,2764,39,0,0,0,0,0,0,39,18,0,0,0,21,2725,795,401,394,47,347,0,1930,470,311,81,230,1149,0,115201
14000US06037115202,140,6,37,1806,16,0,0,0,0,0,0,16,0,16,16,0,0,1790,488,375,100,29,71,13,1302,296,248,70,178,758,0,115202
14000US06037115301,140,6,37,1617,0,0,0,0,0,0,0,0,0,0,0,0,0,1617,332,185,147,38,109,0,1285,481,174,39,135,630,0,115301
14000US06037115302,140,6,37,974,138,129,52,77,25,52,0,9,0,5,5,0,4,836,424,292,132,37,95,0,412,169,48,25,23,195,0,115302
14000US06037115401,140,6,37,1953,235,216,67,149,22,127,0,19,0,13,0,13,6,1718,630,412,218,0,218,0,1088,445,101,44,57,542,0,115401
14000US06037115403,140,6,37,1030,122,116,69,47,12,35,0,6,0,6,6,0,0,908,262,214,35,0,35,13,646,232,119,12,107,295,0,115403
14000US06037115404,140,6,37,794,100,61,42,12,0,12,7,39,0,14,0,14,25,694,316,181,135,72,63,0,378,171,59,21,38,148,0,115404
14000US06037117101,140,6,37,1289,48,48,48,0,0,0,0,0,0,0,0,0,0,1241,668,454,214,132,82,0,573,284,152,72,80,137,0,117101
14000US06037117102,140,6,37,796,22,15,5,0,0,0,10,7,0,7,0,7,0,774,239,169,70,50,20,0,535,159,180,31,149,196,0,117102
14000US06037117201,140,6,37,1139,198,145,145,0,0,0,0,53,10,21,0,21,22,941,489,304,185,100,85,0,452,253,58,22,36,141,0,117201
14000US06037117202,140,6,37,658,15,9,9,0,0,0,0,6,6,0,0,0,0,643,249,233,16,12,4,0,394,215,94,14,80,85,0,117202
14000US06037117301,140,6,37,1232,49,30,16,14,14,0,0,19,0,19,10,9,0,1183,453,399,54,28,26,0,730,370,118,23,95,242,0,117301
14000US06037117302,140,6,37,1632,60,54,45,9,0,9,0,6,0,0,0,0,6,1572,507,376,131,41,90,0,1065,523,115,53,62,427,0,117302
14000US06037117303,140,6,37,1051,9,9,0,9,0,9,0,0,0,0,0,0,0,1042,373,271,95,30,65,7,669,295,174,74,100,200,0,117303
14000US06037117404,140,6,37,1294,16,16,2,14,0,14,0,0,0,0,0,0,0,1278,444,363,81,0,81,0,834,393,132,76,56,309,0,117404
14000US06037117405,140,6,37,826,245,230,80,137,49,88,13,15,0,0,0,0,15,581,407,244,163,34,129,0,174,60,70,46,24,44,0,117405
14000US06037117407,140,6,37,801,235,225,50,175,58,117,0,10,0,10,10,0,0,566,358,250,108,66,42,0,208,120,18,10,8,70,0,117407
14000US06037117408,140,6,37,892,237,226,37,189,68,121,0,11,0,0,0,0,11,655,236,88,148,31,117,0,419,90,52,31,21,277,0,117408
14000US06037117510,140,6,37,1010,241,226,120,106,5,101,0,15,0,8,8,0,7,769,393,177,216,117,99,0,376,118,74,27,47,184,0,117510
14000US06037117520,140,6,37,896,255,231,100,131,9,122,0,24,0,11,0,11,13,641,310,189,112,22,90,9,331,86,130,62,68,115,0,117520
14000US06037117530,140,6,37,1467,243,212,87,125,34,91,0,31,21,1,0,1,9,1224,560,355,180,17,163,25,664,141,170,110,60,353,0,117530
14000US06037119001,140,6,37,951,109,86,76,10,0,10,0,23,23,0,0,0,0,842,364,270,94,30,64,0,478,322,9,6,3,147,0,119001
14000US06037119002,140,6,37,1465,87,87,69,18,11,7,0,0,0,0,0,0,0,1378,777,641,136,33,103,0,601,254,130,26,104,217,0,119002
14000US06037119201,140,6,37,856,109,109,19,90,10,80,0,0,0,0,0,0,0,747,387,281,106,8,98,0,360,149,77,38,39,134,0,119201
14000US06037119202,140,6,37,887,19,19,19,0,0,0,0,0,0,0,0,0,0,868,444,286,151,52,99,7,424,213,93,7,86,118,0,119202
14000US06037119310,140,6,37,1056,88,55,18,37,0,37,0,33,0,24,15,9,9,968,432,252,180,81,99,0,536,185,51,27,24,300,0,119310
14000US06037119320,140,6,37,1090,187,163,62,101,21,80,0,24,24,0,0,0,0,903,477,231,246,76,170,0,426,194,94,59,35,138,0,119320
14000US06037119340,140,6,37,955,219,199,88,111,35,76,0,20,8,7,0,7,5,736,460,174,253,119,134,33,276,83,78,65,13,115,0,119340
14000US06037119341,140,6,37,743,89,27,18,9,6,3,0,62,22,27,0,27,13,654,247,163,84,8,76,0,407,153,66,30,36,188,0,119341
14000US06037119342,140,6,37,761,117,104,65,39,11,28,0,13,0,7,7,0,6,644,344,234,110,60,50,0,300,128,86,26,60,86,0,119342
14000US06037119400,140,6,37,1077,77,77,22,55,0,55,0,0,0,0,0,0,0,1000,543,367,176,75,101,0,457,271,126,60,66,60,0,119400
14000US06037119700,140,6,37,1244,47,30,0,30,10,20,0,17,0,9,0,9,8,1197,473,336,137,37,100,0,724,468,103,55,48,153,0,119700
14000US06037119800,140,6,37,1358,141,141,99,42,0,42,0,0,0,0,0,0,0,1217,593,469,124,93,31,0,624,238,175,66,109,211,0,119800
14000US06037119900,140,6,37,1188,64,64,13,51,18,33,0,0,0,0,0,0,0,1124,578,434,144,7,137,0,546,269,92,9,83,185,0,119900
14000US06037120010,140,6,37,691,35,22,17,5,0,5,0,13,0,13,13,0,0,656,384,310,74,13,61,0,272,124,43,22,21,105,0,120010
14000US06037120020,140,6,37,1103,196,179,58,116,11,105,5,17,0,8,0,8,9,907,541,394,147,45,102,0,366,186,96,26,70,84,0,120020
14000US06037120030,140,6,37,639,174,162,46,116,56,60,0,12,0,0,0,0,12,465,329,257,72,19,53,0,136,33,43,39,4,60,0,120030
14000US06037120103,140,6,37,840,217,217,105,112,53,59,0,0,0,0,0,0,0,623,424,277,147,52,95,0,199,34,66,50,16,99,0,120103
14000US06037120104,140,6,37,770,173,130,42,88,7,81,0,43,22,5,5,0,16,597,194,43,141,47,94,10,403,135,66,36,30,202,0,120104
14000US06037120105,140,6,37,871,68,63,36,27,18,9,0,5,0,0,0,0,5,803,304,213,91,13,78,0,499,158,109,40,69,232,0,120105
14000US06037120106,140,6,37,1171,236,213,65,148,49,99,0,23,0,0,0,0,23,935,461,233,228,88,140,0,474,211,41,37,4,222,0,120106
14000US06037120107,140,6,37,1006,342,267,98,169,14,155,0,75,33,0,0,0,42,664,290,188,102,24,78,0,374,108,27,9,18,239,0,120107
14000US06037120108,140,6,37,1261,116,116,38,78,0,78,0,0,0,0,0,0,0,1145,581,357,224,84,140,0,564,142,166,86,80,256,0,120108
14000US06037120300,140,6,37,1392,91,60,43,17,15,2,0,31,31,0,0,0,0,1301,595,382,213,61,152,0,706,283,274,124,150,149,0,120300
14000US06037120400,140,6,37,1985,267,183,115,68,0,68,0,84,27,47,0,47,10,1718,585,366,211,76,135,8,1133,473,182,19,163,478,0,120400
14000US06037121010,140,6,37,1294,51,51,13,38,0,38,0,0,0,0,0,0,0,1243,529,346,183,35,148,0,714,292,165,73,92,257,0,121010
14000US06037121020,140,6,37,947,119,84,10,74,35,39,0,35,12,4,0,4,19,828,357,292,65,7,58,0,471,163,83,34,49,225,0,121020
14000US06037121101,140,6,37,919,135,125,27,98,23,75,0,10,10,0,0,0,0,784,263,204,59,17,42,0,521,203,62,18,44,256,0,121101
14000US06037121102,140,6,37,784,78,55,23,32,14,18,0,23,0,18,0,18,5,706,247,129,118,22,96,0,459,243,101,35,66,115,0,121102
14000US06037121210,140,6,37,793,89,65,29,36,0,36,0,24,24,0,0,0,0,704,245,129,116,34,82,0,459,196,93,15,78,170,0,121210
14000US06037121221,140,6,37,508,37,29,5,24,8,16,0,8,8,0,0,0,0,471,195,127,68,31,37,0,276,127,63,56,7,86,0,121221
14000US06037121222,140,6,37,1194,312,279,58,221,69,152,0,33,24,9,0,9,0,882,349,239,87,26,61,23,533,163,113,53,60,257,0,121222
14000US06037121600,140,6,37,774,62,23,6,17,0,17,0,39,0,33,0,33,6,712,243,187,50,50,0,6,469,261,102,31,71,106,0,121600
14000US06037121801,140,6,37,1092,185,158,97,61,0,61,0,27,12,8,0,8,7,907,285,201,84,30,54,0,622,157,66,27,39,399,0,121801
14000US06037121802,140,6,37,706,27,27,7,20,0,20,0,0,0,0,0,0,0,679,248,210,38,20,18,0,431,195,94,27,67,142,0,121802
14000US06037121900,140,6,37,1052,153,96,20,76,13,63,0,57,10,21,0,21,26,899,291,231,21,0,21,39,608,287,62,36,26,259,0,121900
14000US06037122000,140,6,37,1483,104,98,56,42,0,42,0,6,0,0,0,0,6,1379,465,361,98,30,68,6,914,323,209,50,159,382,0,122000
14000US06037122120,140,6,37,1123,117,108,35,73,35,38,0,9,0,9,0,9,0,1006,543,391,144,28,116,8,463,245,92,29,63,126,0,122120
14000US06037122121,140,6,37,724,144,112,47,65,0,65,0,32,20,12,5,7,0,580,277,175,102,22,80,0,303,98,85,57,28,120,0,122121
14000US06037122122,140,6,37,605,139,84,24,60,0,60,0,55,0,0,0,0,55,466,164,97,67,13,54,0,302,101,91,28,63,110,0,122122
14000US06037122200,140,6,37,918,112,107,18,89,0,89,0,5,0,5,0,5,0,806,326,242,84,41,43,0,480,262,78,12,66,140,0,122200
14000US06037122410,140,6,37,1052,263,196,62,134,18,116,0,67,8,15,0,15,44,789,311,222,89,43,46,0,478,100,80,14,66,298,0,122410
14000US06037122420,140,6,37,1350,188,149,57,92,22,70,0,39,39,0,0,0,0,1162,520,268,230,71,159,22,642,306,76,17,59,260,0,122420
14000US06037123010,140,6,37,1050,195,134,38,96,26,70,0,61,6,25,12,13,30,855,419,313,89,23,66,17,436,224,78,27,51,134,0,123010
14000US06037123020,140,6,37,778,102,98,63,35,18,17,0,4,0,0,0,0,4,676,277,182,95,27,68,0,399,176,113,70,43,110,0,123020
14000US06037123103,140,6,37,1518,129,110,42,68,23,45,0,19,0,0,0,0,19,1389,491,287,189,68,121,15,898,244,67,0,67,587,0,123103
14000US06037123104,140,6,37,1575,138,56,11,45,0,45,0,82,0,34,0,34,48,1437,392,205,187,93,94,0,1045,251,281,89,192,513,0,123104
14000US06037123203,140,6,37,1040,225,197,76,121,44,77,0,28,20,0,0,0,8,815,313,189,116,63,53,8,502,190,155,62,93,157,0,123203
14000US06037123204,140,6,37,1029,141,128,98,30,15,15,0,13,9,0,0,0,4,888,411,248,163,54,109,0,477,123,101,58,43,253,0,123204
14000US06037123205,140,6,37,692,132,99,42,57,9,48,0,33,0,23,23,0,10,560,299,210,68,27,41,21,261,80,76,39,37,105,0,123205
14000US06037123206,140,6,37,838,100,84,52,32,0,32,0,16,0,6,0,6,10,738,248,210,38,10,28,0,490,134,130,45,85,226,0,123206
14000US06037123301,140,6,37,1527,108,108,29,79,24,55,0,0,0,0,0,0,0,1419,354,288,66,36,30,0,1065,291,170,42,128,604,0,123301
14000US06037123303,140,6,37,903,130,100,62,38,0,38,0,30,26,0,0,0,4,773,347,155,192,76,116,0,426,146,84,29,55,196,0,123303
14000US06037123304,140,6,37,1653,130,106,99,7,0,7,0,24,15,9,9,0,0,1523,354,234,120,59,61,0,1169,472,139,108,31,558,0,123304
14000US06037123410,140,6,37,1206,198,146,61,85,0,85,0,52,20,14,0,14,18,1008,310,172,138,62,76,0,698,240,125,76,49,333,0,123410
14000US06037123420,140,6,37,1407,196,128,59,69,35,34,0,68,52,0,0,0,16,1211,362,224,138,34,104,0,849,290,141,37,104,418,0,123420
14000US06037123510,140,6,37,1492,154,127,21,106,6,100,0,27,7,11,0,11,9,1338,402,291,111,47,64,0,936,355,175,95,80,406,0,123510
14000US06037123520,140,6,37,844,98,38,19,15,0,15,4,60,12,28,0,28,20,746,327,262,65,24,41,0,419,124,103,64,39,192,0,123520
14000US06037123601,140,6,37,1876,126,97,85,12,0,12,0,29,13,0,0,0,16,1750,459,350,109,0,109,0,1291,496,238,103,135,557,0,123601
14000US06037123602,140,6,37,1305,111,111,29,82,14,68,0,0,0,0,0,0,0,1194,337,216,121,39,82,0,857,232,113,26,87,512,0,123602
14000US06037123700,140,6,37,1460,92,20,0,20,0,20,0,72,35,0,0,0,37,1368,411,329,82,29,53,0,957,296,111,26,85,550,0,123700
14000US06037123800,140,6,37,2255,153,94,0,94,0,94,0,59,13,0,0,0,46,2102,402,232,170,27,143,0,1700,415,115,61,54,1170,0,123800
14000US06037123901,140,6,37,1496,83,45,31,14,0,14,0,38,0,25,0,25,13,1413,551,355,196,38,158,0,862,251,127,70,57,484,0,123901
14000US06037123902,140,6,37,1101,54,40,7,23,0,23,10,14,14,0,0,0,0,1047,196,96,100,9,91,0,851,248,96,12,84,507,0,123902
14000US06037124000,140,6,37,2006,58,0,0,0,0,0,0,58,0,0,0,0,58,1948,568,395,173,75,98,0,1380,354,268,137,131,758,0,124000
14000US06037124102,140,6,37,1317,154,85,39,46,10,36,0,69,0,48,0,48,21,1163,360,254,106,33,73,0,803,172,88,42,46,543,0,124102
14000US06037124103,140,6,37,597,83,78,62,16,0,16,0,5,5,0,0,0,0,514,165,78,87,7,80,0,349,191,24,0,24,134,0,124103
14000US06037124104,140,6,37,1034,72,56,10,46,18,28,0,16,0,0,0,0,16,962,251,162,89,32,57,0,711,152,65,13,52,494,0,124104
14000US06037124105,140,6,37,851,49,24,0,24,8,16,0,25,18,0,0,0,7,802,221,131,90,29,61,0,581,207,38,24,14,336,0,124105
14000US06037124201,140,6,37,1070,145,79,26,53,39,14,0,66,12,8,0,8,46,925,336,301,35,12,23,0,589,170,95,10,85,324,0,124201
14000US06037124203,140,6,37,838,148,92,28,64,0,64,0,56,9,0,0,0,47,690,236,159,61,0,61,16,454,210,50,15,35,194,0,124203
14000US06037124204,140,6,37,1011,66,52,6,46,0,46,0,14,0,0,0,0,14,945,361,218,123,57,66,20,584,113,76,12,64,395,0,124204
14000US06037124300,140,6,37,1254,118,108,62,46,28,18,0,10,0,10,0,10,0,1136,359,227,121,22,99,11,777,166,154,78,76,457,0,124300
14000US06037124400,140,6,37,1543,51,24,15,9,0,9,0,27,0,0,0,0,27,1492,491,412,79,48,31,0,1001,335,119,38,81,547,0,124400
14000US06037124500,140,6,37,1191,61,51,51,0,0,0,0,10,10,0,0,0,0,1130,289,201,88,41,47,0,841,273,92,35,57,476,0,124500
14000US06037124600,140,6,37,1416,36,21,0,21,0,21,0,15,15,0,0,0,0,1380,387,268,106,55,51,13,993,293,69,0,69,631,0,124600
14000US06037124700,140,6,37,2047,67,26,14,12,0,12,0,41,0,0,0,0,41,1980,531,339,192,17,175,0,1449,484,143,19,124,822,0,124700
14000US06037124902,140,6,37,1524,54,7,0,7,0,7,0,47,0,0,0,0,47,1470,210,149,61,27,34,0,1260,129,109,36,73,1022,0,124902
14000US06037124903,140,6,37,1648,108,71,3,68,0,68,0,37,0,26,0,26,11,1540,175,83,56,49,7,36,1365,248,64,30,34,1053,0,124903
14000US06037125100,140,6,37,2554,82,60,39,21,0,21,0,22,0,0,0,0,22,2472,576,467,93,36,57,16,1896,298,166,101,65,1432,0,125100
14000US06037125200,140,6,37,1704,63,33,25,8,0,8,0,30,0,12,0,12,18,1641,376,254,122,13,109,0,1265,161,73,35,38,1031,0,125200
14000US06037125310,140,6,37,1940,112,94,54,40,0,40,0,18,0,9,0,9,9,1828,299,99,200,55,145,0,1529,267,134,49,85,1128,0,125310
14000US06037125320,140,6,37,2546,90,76,41,35,12,23,0,14,0,0,0,0,14,2456,292,222,49,17,32,21,2164,277,80,21,59,1807,0,125320
14000US06037125401,140,6,37,2084,59,44,13,31,0,31,0,15,0,0,0,0,15,2025,232,188,44,0,44,0,1793,269,38,0,38,1486,0,125401
14000US06037125402,140,6,37,1965,56,35,13,22,0,22,0,21,0,0,0,0,21,1909,226,186,40,29,11,0,1683,322,164,53,111,1197,0,125402
14000US06037125501,140,6,37,1522,32,18,0,18,0,18,0,14,7,0,0,0,7,1490,356,174,158,66,92,24,1134,166,141,72,69,827,0,125501
14000US06037125502,140,6,37,1646,55,14,0,14,0,14,0,41,33,8,8,0,0,1591,170,59,111,0,111,0,1421,282,59,20,39,1080,0,125502
14000US06037125600,140,6,37,1200,12,0,0,0,0,0,0,12,0,0,0,0,12,1188,307,231,76,24,52,0,881,282,97,69,28,502,0,125600
14000US06037127102,140,6,37,1527,368,304,88,216,72,144,0,64,8,25,0,25,31,1159,591,361,230,107,123,0,568,178,109,56,53,281,0,127102
14000US06037127103,140,6,37,1064,62,41,10,31,0,31,0,21,0,21,0,21,0,1002,383,246,137,0,137,0,619,196,69,24,45,354,0,127103
14000US06037127104,140,6,37,1204,96,70,14,56,23,33,0,26,0,0,0,0,26,1108,402,278,124,73,51,0,706,324,112,7,105,270,0,127104
14000US06037127210,140,6,37,1818,151,82,27,55,0,55,0,69,29,30,0,30,10,1667,561,372,189,31,158,0,1106,273,148,99,49,685,0,127210
14000US06037127220,140,6,37,1654,135,123,34,71,19,52,18,12,0,6,6,0,6,1519,664,439,225,100,125,0,855,304,114,65,49,437,0,127220
14000US06037127300,140,6,37,1605,99,25,0,25,0,25,0,74,36,0,0,0,38,1506,490,318,172,48,124,0,1016,301,111,74,37,604,0,127300
14000US06037127400,140,6,37,1770,224,178,75,103,27,76,0,46,8,38,9,29,0,1546,785,505,280,50,230,0,761,285,154,27,127,322,0,127400
14000US06037127520,140,6,37,1118,194,153,91,62,26,36,0,41,0,11,0,11,30,924,413,253,130,41,89,30,511,90,90,45,45,331,0,127520
14000US06037127603,140,6,37,856,125,125,45,69,11,58,11,0,0,0,0,0,0,731,361,171,190,59,131,0,370,125,63,11,52,182,0,127603
14000US06037127604,140,6,37,1118,54,23,9,14,0,14,0,31,0,19,0,19,12,1064,403,202,201,27,174,0,661,161,120,39,81,380,0,127604
14000US06037127605,140,6,37,1093,16,16,0,16,0,16,0,0,0,0,0,0,0,1077,437,310,127,27,100,0,640,154,66,27,39,420,0,127605
14000US06037127606,140,6,37,1137,112,97,21,76,0,76,0,15,15,0,0,0,0,1025,476,278,198,42,156,0,549,171,110,34,76,268,0,127606
14000US06037127711,140,6,37,1133,72,72,46,26,0,26,0,0,0,0,0,0,0,1061,379,235,144,116,28,0,682,342,86,60,26,254,0,127711
14000US06037127712,140,6,37,1137,84,46,7,39,0,39,0,38,0,0,0,0,38,1053,348,227,121,85,36,0,705,143,102,34,68,460,0,127712
14000US06037127803,140,6,37,1300,146,44,0,44,0,44,0,102,9,17,0,17,76,1154,420,274,146,128,18,0,734,197,140,0,140,397,0,127803
14000US06037127804,140,6,37,1472,39,15,0,15,7,8,0,24,0,8,0,8,16,1433,513,383,130,20,110,0,920,158,170,69,101,592,0,127804
14000US06037127805,140,6,37,1094,30,20,0,20,8,12,0,10,0,0,0,0,10,1064,424,339,85,23,62,0,640,122,160,73,87,358,0,127805
14000US06037127806,140,6,37,1206,83,22,15,7,0,7,0,61,9,0,0,0,52,1123,374,173,201,75,126,0,749,263,66,9,57,420,0,127806
14000US06037127910,140,6,37,1394,222,181,121,60,0,60,0,41,19,8,0,8,14,1172,525,262,263,152,111,0,647,144,159,34,125,344,0,127910
14000US06037127920,140,6,37,1198,178,113,91,22,0,22,0,65,15,41,41,0,9,1020,317,206,111,0,111,0,703,277,162,56,106,264,0,127920
14000US06037128101,140,6,37,1244,78,56,37,19,19,0,0,22,0,15,0,15,7,1166,412,284,128,49,79,0,754,204,91,57,34,459,0,128101
14000US06037128102,140,6,37,1339,207,151,48,103,0,103,0,56,18,24,0,24,14,1132,481,329,152,35,117,0,651,107,218,59,159,326,0,128102
14000US06037128210,140,6,37,1438,221,130,26,104,33,71,0,91,8,43,15,28,40,1217,511,303,208,31,177,0,706,191,123,49,74,392,0,128210
14000US06037128220,140,6,37,1133,123,69,35,34,18,16,0,54,28,7,0,7,19,1010,305,164,141,16,125,0,705,163,96,13,83,446,0,128220
14000US06037128302,140,6,37,1436,180,159,73,86,16,70,0,21,0,7,7,0,14,1256,454,300,126,16,110,28,802,155,169,113,56,478,0,128302
14000US06037128303,140,6,37,1040,251,189,17,154,8,146,18,62,10,22,22,0,30,789,302,259,43,32,11,0,487,165,39,35,4,283,0,128303
14000US06037128400,140,6,37,1739,75,56,47,9,0,9,0,19,0,0,0,0,19,1664,467,295,146,31,115,26,1197,278,172,77,95,747,0,128400
14000US06037128500,140,6,37,1931,49,37,0,37,0,37,0,12,0,12,0,12,0,1882,410,234,176,112,64,0,1472,245,204,66,138,1023,0,128500
14000US06037128601,140,6,37,1611,275,239,60,179,114,65,0,36,0,36,0,36,0,1336,360,170,190,23,167,0,976,167,71,47,24,738,0,128601
14000US06037128602,140,6,37,1310,64,28,0,28,28,0,0,36,12,0,0,0,24,1246,251,168,83,47,36,0,995,334,122,15,107,539,0,128602
14000US06037128702,140,6,37,2647,30,22,0,22,13,9,0,8,0,8,8,0,0,2617,591,480,111,30,81,0,2026,395,123,78,45,1508,0,128702
14000US06037128801,140,6,37,1828,111,74,0,74,9,65,0,37,0,26,0,26,11,1717,201,164,37,0,37,0,1516,375,126,43,83,1015,0,128801
14000US06037128802,140,6,37,2107,69,12,0,12,0,12,0,57,12,4,0,4,41,2038,592,422,170,45,125,0,1446,265,100,67,33,1081,0,128802
14000US06037128910,140,6,37,1717,56,0,0,0,0,0,0,56,10,0,0,0,46,1661,426,404,22,0,22,0,1235,353,82,37,45,800,0,128910
14000US06037131010,140,6,37,1944,305,274,92,182,51,131,0,31,20,0,0,0,11,1639,690,344,346,69,277,0,949,306,191,95,96,452,0,131010
14000US06037131020,140,6,37,1542,119,93,69,24,19,5,0,26,0,0,0,0,26,1423,691,473,212,61,151,6,732,286,97,10,87,349,0,131020
14000US06037131100,140,6,37,1044,45,21,21,0,0,0,0,24,0,24,0,24,0,999,450,358,92,34,58,0,549,263,103,37,66,183,0,131100
14000US06037131200,140,6,37,1162,23,2,0,2,0,2,0,21,11,10,10,0,0,1139,314,208,106,43,63,0,825,366,112,51,61,347,0,131200
14000US06037131300,140,6,37,1130,66,43,43,0,0,0,0,23,12,0,0,0,11,1064,448,213,222,76,146,13,616,228,171,29,142,217,0,131300
14000US06037131400,140,6,37,1840,68,47,12,9,1,8,26,21,4,0,0,0,17,1772,566,329,203,78,125,34,1206,448,186,18,168,572,0,131400
14000US06037131600,140,6,37,1458,71,71,46,25,0,25,0,0,0,0,0,0,0,1387,497,296,201,53,148,0,890,322,280,180,100,288,0,131600
14000US06037131701,140,6,37,1639,105,83,38,45,0,45,0,22,9,13,0,13,0,1534,563,299,264,81,183,0,971,273,118,38,80,580,0,131701
14000US06037131702,140,6,37,1109,62,62,41,21,21,0,0,0,0,0,0,0,0,1047,383,226,157,81,76,0,664,257,73,21,52,334,0,131702
14000US06037131800,140,6,37,1568,207,192,61,131,54,77,0,15,15,0,0,0,0,1361,493,341,152,38,114,0,868,289,242,72,170,337,0,131800
14000US06037131900,140,6,37,1369,20,10,0,10,0,10,0,10,10,0,0,0,0,1349,523,282,230,19,211,11,826,362,129,18,111,335,0,131900
14000US06037132001,140,6,37,1167,15,15,0,15,0,15,0,0,0,0,0,0,0,1152,363,318,45,0,45,0,789,312,144,8,136,333,0,132001
14000US06037132002,140,6,37,1042,31,11,0,11,0,11,0,20,0,0,0,0,20,1011,403,287,116,42,74,0,608,300,82,13,69,226,0,132002
14000US06037132101,140,6,37,1530,38,38,5,33,21,12,0,0,0,0,0,0,0,1492,403,256,147,17,130,0,1089,281,253,176,77,555,0,132101
14000US06037132102,140,6,37,2003,199,153,0,153,117,36,0,46,0,6,0,6,40,1804,422,273,149,93,56,0,1382,322,232,102,130,828,0,132102
14000US06037132300,140,6,37,2375,323,201,70,131,0,131,0,122,51,0,0,0,71,2052,699,545,140,88,52,14,1353,328,226,61,165,799,0,132300
14000US06037132501,140,6,37,1013,87,66,52,14,0,14,0,21,0,9,0,9,12,926,256,195,61,15,46,0,670,341,33,9,24,296,0,132501
14000US06037132502,140,6,37,1209,89,82,56,26,8,18,0,7,7,0,0,0,0,1120,531,252,242,7,235,37,589,177,125,28,97,287,0,132502
14000US06037132700,140,6,37,1478,169,161,112,49,15,34,0,8,8,0,0,0,0,1309,677,431,246,120,126,0,632,217,90,43,47,325,0,132700
14000US06037132900,140,6,37,1297,38,20,20,0,0,0,0,18,18,0,0,0,0,1259,308,212,96,54,42,0,951,347,205,11,194,399,0,132900
14000US06037133000,140,6,37,1209,45,14,14,0,0,0,0,31,5,0,0,0,26,1164,545,397,148,77,71,0,619,167,123,9,114,329,0,133000
14000US06037133100,140,6,37,1942,80,67,15,52,0,52,0,13,0,6,0,6,7,1862,443,347,96,16,80,0,1419,435,250,62,188,734,0,133100
14000US06037134001,140,6,37,923,51,23,23,0,0,0,0,28,0,28,0,28,0,872,496,317,179,94,85,0,376,143,136,57,79,97,0,134001
14000US06037134002,140,6,37,1019,129,94,21,73,20,53,0,35,5,17,13,4,13,890,405,296,109,0,109,0,485,214,91,44,47,180,0,134002
14000US06037134101,140,6,37,1514,104,46,6,40,0,40,0,58,17,41,7,34,0,1410,590,319,263,121,142,8,820,416,162,75,87,242,0,134101
14000US06037134103,140,6,37,1284,60,46,13,33,0,33,0,14,7,0,0,0,7,1224,432,318,114,17,97,0,792,346,70,24,46,376,0,134103
14000US06037134104,140,6,37,1279,109,76,21,55,20,35,0,33,0,0,0,0,33,1170,495,296,199,47,152,0,675,246,61,15,46,368,0,134104
14000US06037134201,140,6,37,1176,36,36,14,22,22,0,0,0,0,0,0,0,0,1140,478,421,57,32,25,0,662,298,142,63,79,222,0,134201
14000US06037134302,140,6,37,1186,23,15,15,0,0,0,0,8,0,0,0,0,8,1163,443,325,118,24,94,0,720,367,93,9,84,260,0,134302
14000US06037134303,140,6,37,1705,55,50,33,17,0,17,0,5,0,5,0,5,0,1650,647,507,140,38,102,0,1003,289,210,48,162,504,0,134303
14000US06037134304,140,6,37,897,34,34,7,27,0,27,0,0,0,0,0,0,0,863,262,187,75,28,47,0,601,276,96,18,78,229,0,134304
14000US06037134305,140,6,37,1072,257,218,126,92,42,50,0,39,15,0,0,0,24,815,454,267,187,85,102,0,361,120,116,50,66,125,0,134305
14000US06037134306,140,6,37,1124,105,80,47,33,19,14,0,25,8,17,0,17,0,1019,392,293,99,26,73,0,627,87,183,53,130,357,0,134306
14000US06037134421,140,6,37,1340,0,0,0,0,0,0,0,0,0,0,0,0,0,1340,542,464,78,42,36,0,798,420,116,16,100,262,0,134421
14000US06037134422,140,6,37,1558,12,12,12,0,0,0,0,0,0,0,0,0,0,1546,627,473,154,92,62,0,919,439,138,47,91,342,0,134422
14000US06037134423,140,6,37,1284,0,0,0,0,0,0,0,0,0,0,0,0,0,1284,394,278,116,81,35,0,890,420,110,49,61,360,0,134423
14000US06037134424,140,6,37,970,3,0,0,0,0,0,0,3,0,0,0,0,3,967,297,291,6,6,0,0,670,539,52,0,52,79,0,134424
14000US06037134520,140,6,37,1727,240,193,88,105,10,95,0,47,0,19,0,19,28,1487,575,245,330,115,215,0,912,138,155,68,87,619,0,134520
14000US06037134521,140,6,37,688,89,89,44,45,25,20,0,0,0,0,0,0,0,599,259,144,115,34,81,0,340,21,79,79,0,240,0,134521
14000US06037134522,140,6,37,1249,55,48,18,30,0,30,0,7,0,0,0,0,7,1194,602,351,251,86,165,0,592,166,140,57,83,286,0,134522
14000US06037134710,140,6,37,1624,265,240,86,154,18,136,0,25,12,7,0,7,6,1359,504,336,168,29,139,0,855,281,157,96,61,417,0,134710
14000US06037134720,140,6,37,1535,81,51,19,32,0,32,0,30,22,0,0,0,8,1454,544,368,153,39,114,23,910,253,160,23,137,497,0,134720
14000US06037134800,140,6,37,1850,78,56,36,20,0,20,0,22,0,12,0,12,10,1772,607,538,69,18,51,0,1165,522,158,25,133,485,0,134800
14000US06037134901,140,6,37,1092,46,40,33,7,7,0,0,6,0,0,0,0,6,1046,368,284,84,6,78,0,678,235,109,62,47,334,0,134901
14000US06037134903,140,6,37,2076,0,0,0,0,0,0,0,0,0,0,0,0,0,2076,531,393,138,12,126,0,1545,380,170,46,124,995,0,134903
14000US06037134904,140,6,37,1465,67,48,30,18,0,18,0,19,0,0,0,0,19,1398,537,430,107,38,69,0,861,251,215,45,170,395,0,134904
14000US06037134905,140,6,37,1455,0,0,0,0,0,0,0,0,0,0,0,0,0,1455,189,102,87,54,33,0,1266,214,95,9,86,957,0,134905
14000US06037135102,140,6,37,1259,31,31,31,0,0,0,0,0,0,0,0,0,0,1228,398,261,137,56,81,0,830,470,85,0,85,275,0,135102
14000US06037135111,140,6,37,1103,67,42,33,9,0,9,0,25,0,6,6,0,19,1036,292,229,63,9,54,0,744,219,79,38,41,446,0,135111
14000US06037135113,140,6,37,1295,32,0,0,0,0,0,0,32,0,0,0,0,32,1263,521,269,216,101,115,36,742,96,108,33,75,538,0,135113
14000US06037135114,140,6,37,2415,26,12,12,0,0,0,0,14,0,0,0,0,14,2389,376,278,97,0,97,1,2013,545,107,41,66,1361,0,135114
14000US06037135201,140,6,37,883,31,7,7,0,0,0,0,24,0,24,0,24,0,852,315,264,51,0,51,0,537,307,58,43,15,172,0,135201
14000US06037135202,140,6,37,1505,21,13,13,0,0,0,0,8,0,0,0,0,8,1484,627,490,137,50,87,0,857,428,108,21,87,321,0,135202
14000US06037135203,140,6,37,2526,31,31,17,14,0,14,0,0,0,0,0,0,0,2495,884,746,138,38,100,0,1611,736,301,124,177,574,0,135203
14000US06037137000,140,6,37,1711,49,4,4,0,0,0,0,45,0,23,0,23,22,1662,606,508,91,35,56,7,1056,600,102,59,43,354,0,137000
14000US06037137103,140,6,37,2140,58,47,34,13,13,0,0,11,0,0,0,0,11,2082,378,253,92,0,92,33,1704,424,204,58,146,1076,0,137103
14000US06037137104,140,6,37,1066,30,30,0,30,0,30,0,0,0,0,0,0,0,1036,169,148,21,21,0,0,867,401,115,41,74,351,0,137104
14000US06037137201,140,6,37,2291,13,13,0,0,0,0,13,0,0,0,0,0,0,2278,730,468,230,53,177,32,1548,476,196,55,141,876,0,137201
14000US06037137301,140,6,37,731,8,0,0,0,0,0,0,8,8,0,0,0,0,723,280,234,46,21,25,0,443,346,21,0,21,76,0,137301
14000US06037137302,140,6,37,1609,9,9,9,0,0,0,0,0,0,0,0,0,0,1600,500,393,107,22,85,0,1100,634,127,8,119,339,0,137302
14000US06037137401,140,6,37,1614,8,0,0,0,0,0,0,8,0,0,0,0,8,1606,538,429,102,41,61,7,1068,477,96,68,28,495,0,137401
14000US06037137402,140,6,37,2000,47,47,0,47,47,0,0,0,0,0,0,0,0,1953,653,420,233,8,225,0,1300,631,127,48,79,542,0,137402
14000US06037137501,140,6,37,1588,19,13,0,13,0,13,0,6,6,0,0,0,0,1569,399,302,97,37,60,0,1170,431,84,28,56,655,0,137501
14000US06037137502,140,6,37,1685,26,0,0,0,0,0,0,26,0,18,0,18,8,1659,410,327,83,39,44,0,1249,481,116,30,86,652,0,137502
14000US06037137504,140,6,37,622,0,0,0,0,0,0,0,0,0,0,0,0,0,622,152,138,14,4,10,0,470,271,54,27,27,145,0,137504
14000US06037138000,140,6,37,1835,0,0,0,0,0,0,0,0,0,0,0,0,0,1835,528,460,68,47,21,0,1307,737,101,64,37,469,0,138000
14000US06037139001,140,6,37,2001,96,66,14,52,0,52,0,30,11,0,0,0,19,1905,579,485,94,0,94,0,1326,449,164,90,74,713,0,139001
14000US06037139200,140,6,37,2201,72,44,0,44,0,44,0,28,0,0,0,0,28,2129,550,439,111,10,101,0,1579,471,411,7,404,697,0,139200
14000US06037139301,140,6,37,1539,80,22,0,22,0,22,0,58,0,20,0,20,38,1459,597,498,85,0,85,14,862,427,146,21,125,289,0,139301
14000US06037139302,140,6,37,1884,112,70,34,36,0,36,0,42,28,14,14,0,0,1772,398,279,108,0,108,11,1374,306,79,30,49,989,0,139302
14000US06037139303,140,6,37,1860,162,114,63,51,11,40,0,48,30,10,0,10,8,1698,439,226,213,9,204,0,1259,171,219,94,125,869,0,139303
14000US06037139401,140,6,37,1187,58,13,0,13,13,0,0,45,9,9,0,9,27,1129,264,169,95,15,80,0,865,156,120,10,110,589,0,139401
14000US06037139402,140,6,37,963,7,0,0,0,0,0,0,7,0,7,0,7,0,956,417,297,99,11,88,21,539,257,105,16,89,177,0,139402
14000US06037139502,140,6,37,1203,13,13,13,0,0,0,0,0,0,0,0,0,0,1190,317,219,98,15,83,0,873,336,143,70,73,394,0,139502
14000US06037139503,140,6,37,2620,45,11,0,11,0,11,0,34,23,0,0,0,11,2575,463,320,103,41,62,40,2112,364,315,165,150,1433,0,139503
14000US06037139504,140,6,37,1788,111,34,34,0,0,0,0,77,47,17,0,17,13,1677,176,134,42,0,42,0,1501,420,100,12,88,981,0,139504
14000US06037139600,140,6,37,2167,114,98,84,14,0,14,0,16,0,0,0,0,16,2053,400,371,29,29,0,0,1653,619,177,38,139,857,0,139600
14000US06037139701,140,6,37,1948,0,0,0,0,0,0,0,0,0,0,0,0,0,1948,557,528,29,0,29,0,1391,741,111,103,8,539,0,139701
14000US06037139702,140,6,37,2288,11,11,11,0,0,0,0,0,0,0,0,0,0,2277,731,676,55,22,33,0,1546,882,133,0,133,531,0,139702
14000US06037139703,140,6,37,1004,0,0,0,0,0,0,0,0,0,0,0,0,0,1004,335,329,6,0,6,0,669,438,46,28,18,185,0,139703
14000US06037139801,140,6,37,1195,0,0,0,0,0,0,0,0,0,0,0,0,0,1195,406,386,20,10,10,0,789,516,36,36,0,237,0,139801
14000US06037139802,140,6,37,1335,24,24,0,24,0,24,0,0,0,0,0,0,0,1311,372,328,44,10,34,0,939,678,8,0,8,253,0,139802
14000US06037141101,140,6,37,2241,45,31,31,0,0,0,0,14,0,0,0,0,14,2196,400,262,138,55,83,0,1796,325,170,114,56,1301,0,141101
14000US06037141102,140,6,37,1353,59,34,7,27,27,0,0,25,25,0,0,0,0,1294,386,274,112,70,42,0,908,347,12,0,12,549,0,141102
14000US06037141201,140,6,37,1889,39,17,8,9,0,9,0,22,12,0,0,0,10,1850,327,189,138,47,91,0,1523,253,47,0,47,1223,0,141201
14000US06037141202,140,6,37,1294,0,0,0,0,0,0,0,0,0,0,0,0,0,1294,228,190,38,18,20,0,1066,338,83,19,64,645,0,141202
14000US06037141302,140,6,37,2898,0,0,0,0,0,0,0,0,0,0,0,0,0,2898,453,336,117,14,103,0,2445,403,307,157,150,1735,0,141302
14000US06037141303,140,6,37,1767,0,0,0,0,0,0,0,0,0,0,0,0,0,1767,265,201,64,0,64,0,1502,351,149,20,129,1002,0,141303
14000US06037141304,140,6,37,1498,18,0,0,0,0,0,0,18,10,0,0,0,8,1480,405,331,74,40,34,0,1075,152,81,74,7,842,0,141304
14000US06037141400,140,6,37,1980,14,14,0,14,0,14,0,0,0,0,0,0,0,1966,421,389,32,0,32,0,1545,516,230,106,124,799,0,141400
14000US06037141500,140,6,37,1116,10,10,10,0,0,0,0,0,0,0,0,0,0,1106,367,295,54,23,31,18,739,460,27,10,17,252,0,141500
14000US06037141600,140,6,37,1602,39,8,0,8,8,0,0,31,0,0,0,0,31,1563,313,253,60,23,37,0,1250,652,68,20,48,530,0,141600
14000US06037141700,140,6,37,1273,0,0,0,0,0,0,0,0,0,0,0,0,0,1273,360,297,63,38,25,0,913,392,68,36,32,453,0,141700
14000US06037143100,140,6,37,2107,38,38,38,0,0,0,0,0,0,0,0,0,0,2069,323,196,127,65,62,0,1746,371,100,0,100,1275,0,143100
14000US06037143200,140,6,37,1966,0,0,0,0,0,0,0,0,0,0,0,0,0,1966,427,329,98,40,58,0,1539,249,56,44,12,1234,0,143200
14000US06037143300,140,6,37,2979,9,9,9,0,0,0,0,0,0,0,0,0,0,2970,767,375,392,76,316,0,2203,442,132,45,87,1629,0,143300
14000US06037143400,140,6,37,2904,0,0,0,0,0,0,0,0,0,0,0,0,0,2904,660,565,95,0,95,0,2244,335,253,102,151,1656,0,143400
14000US06037143500,140,6,37,2079,13,13,0,13,13,0,0,0,0,0,0,0,0,2066,422,345,77,77,0,0,1644,471,79,0,79,1094,0,143500
14000US06037143602,140,6,37,2003,15,0,0,0,0,0,0,15,0,0,0,0,15,1988,436,286,150,0,150,0,1552,414,38,0,38,1100,0,143602
14000US06037143603,140,6,37,1275,0,0,0,0,0,0,0,0,0,0,0,0,0,1275,159,127,32,0,32,0,1116,209,21,0,21,886,0,143603
14000US06037143604,140,6,37,1937,7,0,0,0,0,0,0,7,0,0,0,0,7,1930,155,72,83,0,83,0,1775,173,32,19,13,1570,0,143604
14000US06037143700,140,6,37,1861,7,0,0,0,0,0,0,7,0,0,0,0,7,1854,315,287,28,6,22,0,1539,475,155,99,56,909,0,143700
14000US06037143800,140,6,37,2316,0,0,0,0,0,0,0,0,0,0,0,0,0,2316,553,452,101,27,74,0,1763,530,131,57,74,1102,0,143800
14000US06037143901,140,6,37,1660,0,0,0,0,0,0,0,0,0,0,0,0,0,1660,522,416,88,52,36,18,1138,457,45,0,45,636,0,143901
14000US06037143902,140,6,37,1378,0,0,0,0,0,0,0,0,0,0,0,0,0,1378,238,177,61,7,54,0,1140,213,132,36,96,795,0,143902
14000US06037181000,140,6,37,2243,11,0,0,0,0,0,0,11,11,0,0,0,0,2232,598,435,163,0,163,0,1634,816,136,67,69,682,0,181000
14000US06037181300,140,6,37,1343,0,0,0,0,0,0,0,0,0,0,0,0,0,1343,387,283,104,15,89,0,956,372,162,0,162,422,0,181300
14000US06037181400,140,6,37,1617,100,73,26,47,11,36,0,27,0,27,0,27,0,1517,458,344,114,20,94,0,1059,259,160,106,54,640,0,181400
14000US06037181500,140,6,37,1214,40,40,33,7,0,7,0,0,0,0,0,0,0,1174,354,286,68,32,36,0,820,307,154,82,72,359,0,181500
14000US06037181600,140,6,37,1002,51,29,0,29,0,29,0,22,0,22,0,22,0,951,265,161,100,14,86,4,686,239,144,114,30,303,0,181600
14000US06037183101,140,6,37,1287,73,70,47,23,0,23,0,3,0,3,0,3,0,1214,349,204,145,42,103,0,865,264,152,46,106,449,0,183101
14000US06037183103,140,6,37,1381,68,25,24,1,0,1,0,43,0,0,0,0,43,1313,419,189,230,28,202,0,894,222,171,68,103,501,0,183103
14000US06037183104,140,6,37,747,8,4,4,0,0,0,0,4,4,0,0,0,0,739,253,213,40,6,34,0,486,90,68,54,14,328,0,183104
14000US06037183220,140,6,37,1160,150,117,25,92,0,92,0,33,0,0,0,0,33,1010,434,240,194,17,177,0,576,243,102,40,62,231,0,183220
14000US06037183221,140,6,37,1026,64,64,22,42,0,42,0,0,0,0,0,0,0,962,319,274,45,0,45,0,643,283,92,29,63,268,0,183221
14000US06037183222,140,6,37,1252,61,35,0,35,0,35,0,26,11,8,8,0,7,1191,252,142,110,56,54,0,939,261,93,6,87,585,0,183222
14000US06037183300,140,6,37,1036,95,55,6,49,10,39,0,40,5,20,0,20,15,941,416,303,113,5,108,0,525,204,94,25,69,227,0,183300
14000US06037183401,140,6,37,805,18,0,0,0,0,0,0,18,0,0,0,0,18,787,290,197,93,35,58,0,497,183,147,50,97,167,0,183401
14000US06037183402,140,6,37,893,47,29,9,20,5,15,0,18,14,4,0,4,0,846,298,178,107,22,85,13,548,156,82,0,82,310,0,183402
14000US06037183510,140,6,37,743,34,34,6,28,0,28,0,0,0,0,0,0,0,709,254,203,51,15,36,0,455,217,65,12,53,173,0,183510
14000US06037183520,140,6,37,998,157,120,42,78,32,46,0,37,0,10,10,0,27,841,355,243,112,39,73,0,486,147,115,40,75,224,0,183520
14000US06037183610,140,6,37,917,91,67,53,14,0,14,0,24,11,0,0,0,13,826,310,165,140,76,64,5,516,131,108,31,77,277,0,183610
14000US06037183620,140,6,37,935,149,130,28,90,9,81,12,19,10,5,0,5,4,786,288,159,129,21,108,0,498,187,63,25,38,248,0,183620
14000US06037183701,140,6,37,1240,197,106,24,82,0,82,0,91,0,15,0,15,76,1043,207,128,79,0,79,0,836,162,55,2,53,619,0,183701
14000US06037183702,140,6,37,1108,31,22,0,22,22,0,0,9,9,0,0,0,0,1077,408,195,213,95,118,0,669,227,91,12,79,351,0,183702
14000US06037183810,140,6,37,1246,303,281,79,202,61,141,0,22,17,0,0,0,5,943,309,155,154,42,112,0,634,194,153,96,57,287,0,183810
14000US06037183820,140,6,37,957,187,126,91,35,0,35,0,61,8,22,0,22,31,770,379,246,133,35,98,0,391,146,52,0,52,193,0,183820
14000US06037185100,140,6,37,2124,173,141,95,46,0,46,0,32,0,25,12,13,7,1951,559,478,81,81,0,0,1392,554,145,72,73,693,0,185100
14000US06037185202,140,6,37,1332,177,127,0,127,27,100,0,50,8,23,23,0,19,1155,261,206,55,25,30,0,894,158,169,86,83,567,0,185202
14000US06037185203,140,6,37,936,74,60,28,32,4,28,0,14,6,8,8,0,0,862,372,223,149,72,77,0,490,198,25,5,20,267,0,185203
14000US06037185204,140,6,37,654,36,15,0,15,0,15,0,21,6,5,0,5,10,618,167,111,56,8,48,0,451,237,92,21,71,122,0,185204
14000US06037185310,140,6,37,777,124,109,47,62,27,35,0,15,5,0,0,0,10,653,301,175,126,28,98,0,352,159,119,20,99,74,0,185310
14000US06037185320,140,6,37,883,120,54,45,9,0,9,0,66,17,5,0,5,44,763,265,143,122,64,58,0,498,178,45,33,12,275,0,185320
14000US06037186100,140,6,37,1660,80,45,34,11,0,11,0,35,8,12,12,0,15,1580,492,363,129,12,117,0,1088,397,89,22,67,602,0,186100
14000US06037186201,140,6,37,1099,43,23,11,12,0,12,0,20,0,0,0,0,20,1056,294,158,136,56,80,0,762,260,125,41,84,377,0,186201
14000US06037186202,140,6,37,718,24,24,24,0,0,0,0,0,0,0,0,0,0,694,229,117,112,72,40,0,465,131,134,75,59,200,0,186202
14000US06037186203,140,6,37,1079,81,50,50,0,0,0,0,31,4,12,12,0,15,998,254,220,34,0,34,0,744,249,93,19,74,402,0,186203
14000US06037186301,140,6,37,857,148,138,32,95,45,50,11,10,0,5,0,5,5,709,164,138,15,7,8,11,545,145,122,50,72,278,0,186301
14000US06037186302,140,6,37,1620,154,149,0,149,0,149,0,5,0,0,0,0,5,1466,352,231,110,87,23,11,1114,417,90,42,48,607,0,186302
14000US06037186401,140,6,37,999,177,155,22,133,33,100,0,22,9,13,9,4,0,822,409,279,130,44,86,0,413,108,94,46,48,211,0,186401
14000US06037186403,140,6,37,828,82,82,28,54,0,54,0,0,0,0,0,0,0,746,335,192,143,41,102,0,411,170,81,51,30,160,0,186403
14000US06037186404,140,6,37,683,78,78,12,66,30,36,0,0,0,0,0,0,0,605,217,140,77,25,52,0,388,122,55,24,31,211,0,186404
14000US06037187101,140,6,37,1249,147,78,34,44,0,44,0,69,27,0,0,0,42,1102,174,102,72,12,60,0,928,272,120,24,96,536,0,187101
14000US06037187102,140,6,37,1105,12,0,0,0,0,0,0,12,0,0,0,0,12,1093,311,238,73,0,73,0,782,223,136,33,103,423,0,187102
14000US06037187200,140,6,37,912,133,86,57,29,0,29,0,47,12,5,5,0,30,779,304,221,83,31,52,0,475,205,96,43,53,174,0,187200
14000US06037187300,140,6,37,1470,34,8,0,8,0,8,0,26,0,11,11,0,15,1436,251,220,31,0,31,0,1185,313,113,28,85,759,0,187300
14000US06037188100,140,6,37,1695,70,38,0,38,0,38,0,32,0,0,0,0,32,1625,350,184,131,51,80,35,1275,195,117,18,99,963,0,188100
14000US06037188201,140,6,37,1904,6,0,0,0,0,0,0,6,0,0,0,0,6,1898,283,233,50,24,26,0,1615,298,28,16,12,1289,0,188201
14000US06037188202,140,6,37,1178,3,0,0,0,0,0,0,3,0,0,0,0,3,1175,275,184,91,0,91,0,900,221,74,36,38,605,0,188202
14000US06037188300,140,6,37,1385,51,29,29,0,0,0,0,22,9,0,0,0,13,1334,269,122,147,28,119,0,1065,424,103,45,58,538,0,188300
14000US06037189101,140,6,37,1470,14,0,0,0,0,0,0,14,0,0,0,0,14,1456,113,105,8,8,0,0,1343,230,200,27,173,913,0,189101
14000US06037189102,140,6,37,1709,50,0,0,0,0,0,0,50,0,0,0,0,50,1659,210,134,76,0,76,0,1449,225,36,0,36,1188,0,189102
14000US06037189201,140,6,37,1930,68,42,29,13,0,13,0,26,0,0,0,0,26,1862,143,100,43,33,10,0,1719,265,39,13,26,1415,0,189201
14000US06037189202,140,6,37,1243,8,8,8,0,0,0,0,0,0,0,0,0,0,1235,120,59,61,15,46,0,1115,277,104,66,38,734,0,189202
14000US06037189300,140,6,37,1412,14,0,0,0,0,0,0,14,0,0,0,0,14,1398,232,205,27,14,13,0,1166,419,101,23,78,646,0,189300
14000US06037189400,140,6,37,1808,8,0,0,0,0,0,0,8,0,0,0,0,8,1800,243,198,45,24,21,0,1557,308,79,12,67,1170,0,189400
14000US06037189500,140,6,37,2815,45,13,0,13,0,13,0,32,6,0,0,0,26,2770,245,132,113,43,70,0,2525,315,71,41,30,2139,0,189500
14000US06037189600,140,6,37,2101,60,9,0,9,0,9,0,51,0,31,0,31,20,2041,168,149,4,0,4,15,1873,205,72,18,54,1596,0,189600
14000US06037189701,140,6,37,2025,12,0,0,0,0,0,0,12,0,0,0,0,12,2013,256,160,96,64,32,0,1757,263,169,71,98,1325,0,189701
14000US06037189702,140,6,37,1348,0,0,0,0,0,0,0,0,0,0,0,0,0,1348,126,96,30,12,18,0,1222,166,0,0,0,1056,0,189702
14000US06037189800,140,6,37,2450,14,0,0,0,0,0,0,14,14,0,0,0,0,2436,162,157,5,0,5,0,2274,225,169,81,88,1880,0,189800
14000US06037189902,140,6,37,3210,45,0,0,0,0,0,0,45,22,11,11,0,12,3165,101,71,30,0,30,0,3064,340,125,12,113,2599,0,189902
14000US06037189903,140,6,37,1379,11,0,0,0,0,0,0,11,0,0,0,0,11,1368,34,34,0,0,0,0,1334,169,38,33,5,1127,0,189903
14000US06037189904,140,6,37,1531,46,30,0,30,0,30,0,16,0,0,0,0,16,1485,45,26,19,0,19,0,1440,183,75,42,33,1182,0,189904
14000US06037189905,140,6,37,1463,23,0,0,0,0,0,0,23,23,0,0,0,0,1440,206,145,61,27,34,0,1234,103,16,0,16,1115,0,189905
14000US06037190100,140,6,37,2654,90,75,48,27,0,27,0,15,0,0,0,0,15,2564,125,125,0,0,0,0,2439,197,80,30,50,2162,0,190100
14000US06037190201,140,6,37,1455,92,25,0,25,0,25,0,67,32,14,14,0,21,1363,58,0,58,35,23,0,1305,58,50,50,0,1197,0,190201
14000US06037190202,140,6,37,2073,51,0,0,0,0,0,0,51,0,0,0,0,51,2022,75,29,46,0,46,0,1947,112,0,0,0,1835,0,190202
14000US06037190301,140,6,37,2326,69,13,0,13,0,13,0,56,0,42,0,42,14,2257,227,101,126,30,96,0,2030,402,205,88,117,1423,0,190301
14000US06037190401,140,6,37,1763,73,65,0,65,30,35,0,8,0,0,0,0,8,1690,156,156,0,0,0,0,1534,213,139,64,75,1182,0,190401
14000US06037190402,140,6,37,1272,87,48,20,28,9,19,0,39,22,17,0,17,0,1185,115,75,40,0,40,0,1070,110,130,59,71,830,0,190402
14000US06037190510,140,6,37,1687,209,176,60,116,0,116,0,33,0,0,0,0,33,1478,279,178,101,47,54,0,1199,248,187,77,110,764,0,190510
14000US06037190520,140,6,37,1568,196,150,52,98,41,57,0,46,18,9,0,9,19,1372,305,161,144,70,74,0,1067,218,45,13,32,804,0,190520
14000US06037190700,140,6,37,1773,87,37,12,25,0,25,0,50,0,0,0,0,50,1686,143,87,56,24,32,0,1543,148,81,21,60,1314,0,190700
14000US06037190801,140,6,37,1339,81,36,25,11,0,11,0,45,33,0,0,0,12,1258,83,71,12,0,12,0,1175,70,45,22,23,1060,0,190801
14000US06037190802,140,6,37,1396,101,38,38,0,0,0,0,63,0,0,0,0,63,1295,243,188,55,0,55,0,1052,92,97,0,97,863,0,190802
14000US06037190901,140,6,37,1411,210,146,60,86,0,86,0,64,9,43,22,21,12,1201,397,181,216,28,188,0,804,177,62,0,62,565,0,190901
14000US06037190902,140,6,37,1603,177,110,25,85,16,69,0,67,0,15,0,15,52,1426,379,224,155,22,133,0,1047,167,148,29,119,732,0,190902
14000US06037191000,140,6,37,1657,118,76,46,30,30,0,0,42,0,0,0,0,42,1539,238,104,134,35,99,0,1301,147,113,42,71,1041,0,191000
14000US06037191110,140,6,37,1095,124,74,0,74,32,42,0,50,0,14,0,14,36,971,149,97,52,0,52,0,822,132,152,58,94,538,0,191110
14000US06037191120,140,6,37,1558,111,111,80,31,0,31,0,0,0,0,0,0,0,1447,391,171,220,82,138,0,1056,326,54,0,54,676,0,191120
14000US06037191201,140,6,37,1661,103,52,30,22,10,12,0,51,13,0,0,0,38,1558,268,170,98,53,45,0,1290,292,257,36,221,741,0,191201
14000US06037191203,140,6,37,1190,164,119,27,92,29,63,0,45,23,12,0,12,10,1026,129,55,50,24,26,24,897,194,123,34,89,580,0,191203
14000US06037191204,140,6,37,781,57,13,13,0,0,0,0,44,23,1,1,0,20,724,107,64,43,0,43,0,617,131,89,29,60,397,0,191204
14000US06037191301,140,6,37,965,109,86,37,49,0,49,0,23,16,0,0,0,7,856,178,137,41,0,41,0,678,174,74,31,43,430,0,191301
14000US06037191302,140,6,37,961,106,33,19,14,0,14,0,73,8,33,0,33,32,855,221,153,68,22,46,0,634,116,83,0,83,435,0,191302
14000US06037191410,140,6,37,1649,186,133,73,60,28,32,0,53,8,0,0,0,45,1463,561,305,256,109,147,0,902,203,54,19,35,645,0,191410
14000US06037191420,140,6,37,1166,214,171,62,109,23,86,0,43,0,15,0,15,28,952,391,280,102,20,82,9,561,63,99,5,94,399,0,191420
14000US06037191500,140,6,37,1655,321,275,105,170,38,132,0,46,27,0,0,0,19,1334,550,345,205,113,92,0,784,285,119,49,70,380,0,191500
14000US06037191610,140,6,37,1407,143,109,28,81,14,67,0,34,0,10,10,0,24,1264,326,149,168,70,98,9,938,233,243,92,151,462,0,191610
14000US06037191620,140,6,37,1053,114,83,49,34,23,11,0,31,21,0,0,0,10,939,167,61,106,10,96,0,772,124,111,64,47,537,0,191620
14000US06037191710,140,6,37,1256,99,48,6,42,19,23,0,51,0,23,8,15,28,1157,280,132,141,63,78,7,877,102,142,48,94,633,0,191710
14000US06037191720,140,6,37,1319,102,77,39,38,0,38,0,25,0,0,0,0,25,1217,491,315,176,52,124,0,726,200,79,34,45,447,0,191720
14000US06037191810,140,6,37,1364,135,106,51,55,0,55,0,29,0,9,0,9,20,1229,361,182,179,28,151,0,868,99,156,120,36,613,0,191810
14000US06037191820,140,6,37,1181,72,34,4,30,20,10,0,38,0,7,7,0,31,1109,222,149,73,17,56,0,887,133,127,71,56,627,0,191820
14000US06037191901,140,6,37,1835,33,18,0,18,0,18,0,15,0,15,0,15,0,1802,148,109,39,0,39,0,1654,186,139,101,38,1329,0,191901
14000US06037191902,140,6,37,1420,18,5,0,5,0,5,0,13,0,0,0,0,13,1402,314,281,33,26,7,0,1088,200,86,22,64,802,0,191902
14000US06037192001,140,6,37,1215,0,0,0,0,0,0,0,0,0,0,0,0,0,1215,110,110,0,0,0,0,1105,200,27,0,27,878,0,192001
14000US06037192002,140,6,37,1361,22,12,0,12,12,0,0,10,0,10,0,10,0,1339,72,63,9,0,9,0,1267,212,94,30,64,961,0,192002
14000US06037192300,140,6,37,1608,0,0,0,0,0,0,0,0,0,0,0,0,0,1608,188,136,52,6,46,0,1420,179,95,54,41,1146,0,192300
14000US06037192410,140,6,37,1720,45,10,0,10,0,10,0,35,0,19,10,9,16,1675,275,250,25,25,0,0,1400,279,131,0,131,990,0,192410
14000US06037192420,140,6,37,1336,17,0,0,0,0,0,0,17,0,7,7,0,10,1319,507,385,122,27,95,0,812,243,75,28,47,494,0,192420
14000US06037192510,140,6,37,1204,107,42,23,19,11,8,0,65,7,58,0,58,0,1097,359,254,105,26,79,0,738,261,219,63,156,258,0,192510
14000US06037192520,140,6,37,1555,122,73,8,65,8,57,0,49,7,24,0,24,18,1433,701,369,332,86,246,0,732,116,198,102,96,418,0,192520
14000US06037192610,140,6,37,1457,166,124,122,2,0,2,0,42,15,0,0,0,27,1291,414,242,172,73,99,0,877,305,129,25,104,443,0,192610
14000US06037192620,140,6,37,1283,198,152,50,102,60,42,0,46,0,16,0,16,30,1085,311,144,167,68,99,0,774,210,114,57,57,450,0,192620
14000US06037192700,140,6,37,1040,81,55,0,55,0,55,0,26,0,0,0,0,26,959,130,48,82,7,75,0,829,69,223,41,182,537,0,192700
14000US06037194101,140,6,37,1661,54,44,0,44,0,44,0,10,0,0,0,0,10,1607,222,107,115,55,60,0,1385,89,48,9,39,1248,0,194101
14000US06037194102,140,6,37,1539,0,0,0,0,0,0,0,0,0,0,0,0,0,1539,284,207,77,20,57,0,1255,358,55,55,0,842,0,194102
14000US06037194200,140,6,37,1720,0,0,0,0,0,0,0,0,0,0,0,0,0,1720,343,272,71,22,49,0,1377,394,46,24,22,937,0,194200
14000US06037194300,140,6,37,1490,11,11,0,11,0,11,0,0,0,0,0,0,0,1479,337,286,51,36,15,0,1142,340,20,15,5,782,0,194300
14000US06037194401,140,6,37,1287,8,0,0,0,0,0,0,8,0,0,0,0,8,1279,82,47,35,0,35,0,1197,215,122,22,100,860,0,194401
14000US06037194402,140,6,37,2026,9,0,0,0,0,0,0,9,0,0,0,0,9,2017,180,73,107,29,78,0,1837,410,24,15,9,1403,0,194402
14000US06037194500,140,6,37,996,15,0,0,0,0,0,0,15,5,0,0,0,10,981,149,135,14,4,10,0,832,258,94,15,79,480,0,194500
14000US06037195100,140,6,37,2083,15,0,0,0,0,0,0,15,0,0,0,0,15,2068,428,357,71,9,62,0,1640,567,62,0,62,1011,0,195100
14000US06037195201,140,6,37,1537,9,0,0,0,0,0,0,9,0,0,0,0,9,1528,190,146,44,0,44,0,1338,153,90,42,48,1095,0,195201
14000US06037195202,140,6,37,1466,31,0,0,0,0,0,0,31,0,0,0,0,31,1435,314,306,8,8,0,0,1121,388,113,66,47,620,0,195202
14000US06037195300,140,6,37,1520,70,48,48,0,0,0,0,22,0,0,0,0,22,1450,258,154,104,42,62,0,1192,181,127,35,92,884,0,195300
14000US06037195400,140,6,37,2252,24,8,8,0,0,0,0,16,0,0,0,0,16,2228,169,104,65,19,46,0,2059,356,102,37,65,1601,0,195400
14000US06037195500,140,6,37,2247,98,55,0,35,20,15,20,43,20,23,0,23,0,2149,409,244,165,93,72,0,1740,331,256,22,234,1153,0,195500
14000US06037195600,140,6,37,1214,155,127,52,75,0,75,0,28,11,0,0,0,17,1059,247,205,42,0,42,0,812,178,114,8,106,520,0,195600
14000US06037195710,140,6,37,1347,207,150,68,82,31,51,0,57,6,7,7,0,44,1140,483,309,174,43,131,0,657,207,161,69,92,289,0,195710
14000US06037195720,140,6,37,833,87,65,0,65,13,52,0,22,0,2,2,0,20,746,147,78,69,18,51,0,599,187,100,36,64,312,0,195720
14000US06037195802,140,6,37,927,142,114,37,77,25,52,0,28,6,15,0,15,7,785,247,137,110,27,83,0,538,140,103,22,81,295,0,195802
14000US06037195803,140,6,37,1171,53,30,0,30,0,30,0,23,5,18,0,18,0,1118,175,115,60,22,38,0,943,209,71,17,54,663,0,195803
14000US06037195804,140,6,37,1085,103,81,0,81,0,81,0,22,0,0,0,0,22,982,114,49,65,24,41,0,868,182,170,81,89,516,0,195804
14000US06037195901,140,6,37,1127,34,15,0,15,0,15,0,19,0,0,0,0,19,1093,156,143,13,0,13,0,937,140,52,20,32,745,0,195901
14000US06037195902,140,6,37,1004,24,0,0,0,0,0,0,24,0,16,16,0,8,980,135,111,24,0,24,0,845,100,12,0,12,733,0,195902
14000US06037195903,140,6,37,987,69,42,15,14,0,14,13,27,0,14,14,0,13,918,176,118,58,5,53,0,742,156,58,43,15,528,0,195903
14000US06037197200,140,6,37,1137,79,79,14,65,57,8,0,0,0,0,0,0,0,1058,292,228,64,9,55,0,766,203,213,127,86,350,0,197200
14000US06037197300,140,6,37,1797,113,60,33,27,0,27,0,53,7,25,0,25,21,1684,279,147,132,9,123,0,1405,257,114,10,104,1034,0,197300
14000US06037197410,140,6,37,1660,40,31,0,31,0,31,0,9,0,0,0,0,9,1620,333,253,80,12,68,0,1287,306,71,25,46,910,0,197410
14000US06037197420,140,6,37,1270,68,36,5,31,9,22,0,32,0,0,0,0,32,1202,318,199,113,44,69,6,884,169,71,7,64,644,0,197420
14000US06037197500,140,6,37,1528,97,61,43,18,0,18,0,36,0,0,0,0,36,1431,329,197,132,66,66,0,1102,314,144,36,108,644,0,197500
14000US06037197600,140,6,37,941,73,66,60,6,0,6,0,7,7,0,0,0,0,868,179,131,48,36,12,0,689,103,102,47,55,484,0,197600
14000US06037197700,140,6,37,1703,232,129,79,50,0,50,0,103,13,35,0,35,55,1471,431,229,202,74,128,0,1040,257,143,33,110,640,0,197700
14000US06037199000,140,6,37,1526,322,219,115,104,30,74,0,103,12,66,8,58,25,1204,347,213,134,57,77,0,857,279,189,75,114,389,0,199000
14000US06037199110,140,6,37,747,66,42,17,25,0,25,0,24,19,0,0,0,5,681,271,156,115,58,57,0,410,116,104,34,70,190,0,199110
14000US06037199120,140,6,37,1031,315,258,132,99,0,99,27,57,16,28,6,22,13,716,308,218,90,0,90,0,408,213,98,69,29,97,0,199120
14000US06037199201,140,6,37,1159,175,131,80,51,31,20,0,44,6,0,0,0,38,984,441,215,226,113,113,0,543,176,140,70,70,227,0,199201
14000US06037199202,140,6,37,832,109,74,30,44,23,21,0,35,5,6,0,6,24,723,242,144,98,0,98,0,481,198,45,10,35,238,0,199202
14000US06037199300,140,6,37,1189,154,140,106,34,34,0,0,14,0,4,0,4,10,1035,403,322,81,46,35,0,632,205,132,11,121,295,0,199300
14000US06037199400,140,6,37,1313,180,157,80,77,10,67,0,23,0,0,0,0,23,1133,414,329,85,19,66,0,719,218,209,51,158,292,0,199400
14000US06037199700,140,6,37,1036,119,99,37,62,41,21,0,20,20,0,0,0,0,917,311,177,134,14,120,0,606,142,130,51,79,334,0,199700
14000US06037199800,140,6,37,1538,142,133,58,75,22,53,0,9,9,0,0,0,0,1396,548,388,160,79,81,0,848,316,212,36,176,320,0,199800
14000US06037199900,140,6,37,789,157,134,58,76,12,64,0,23,13,10,0,10,0,632,233,148,85,46,39,0,399,76,111,61,50,212,0,199900
14000US06037201110,140,6,37,748,101,65,37,28,3,25,0,36,0,30,0,30,6,647,292,189,103,19,84,0,355,127,107,27,80,121,0,201110
14000US06037201120,140,6,37,1292,244,230,73,157,27,130,0,14,0,0,0,0,14,1048,368,241,127,7,120,0,680,171,140,54,86,369,0,201120
14000US06037201200,140,6,37,702,104,75,12,63,5,58,0,29,29,0,0,0,0,598,285,171,114,44,70,0,313,144,57,30,27,112,0,201200
14000US06037201301,140,6,37,997,173,127,53,74,12,62,0,46,0,29,0,29,17,824,229,147,82,33,49,0,595,195,118,22,96,282,0,201301
14000US06037201302,140,6,37,1864,47,13,13,0,0,0,0,34,0,34,0,34,0,1817,237,178,59,12,47,0,1580,427,180,56,124,973,0,201302
14000US06037201401,140,6,37,1356,216,213,17,196,16,180,0,3,0,3,3,0,0,1140,412,245,167,58,109,0,728,298,181,63,118,249,0,201401
14000US06037201402,140,6,37,1317,188,108,92,16,0,16,0,80,16,41,9,32,23,1129,299,160,139,48,91,0,830,322,165,82,83,343,0,201402
14000US06037201501,140,6,37,1502,123,90,25,46,0,46,19,33,6,0,0,0,27,1379,566,352,214,52,162,0,813,311,177,90,87,325,0,201501
14000US06037201503,140,6,37,867,183,160,77,83,13,70,0,23,0,13,0,13,10,684,333,160,152,69,83,21,351,106,96,54,42,149,0,201503
14000US06037201504,140,6,37,559,61,55,15,40,0,40,0,6,0,6,0,6,0,498,185,139,46,5,41,0,313,185,73,33,40,55,0,201504
14000US06037201601,140,6,37,653,53,28,0,28,0,28,0,25,0,0,0,0,25,600,235,144,91,45,46,0,365,106,136,49,87,123,0,201601
14000US06037201602,140,6,37,793,57,53,29,24,0,24,0,4,4,0,0,0,0,736,276,195,75,0,75,6,460,219,36,24,12,205,0,201602
14000US06037201700,140,6,37,1301,177,177,97,80,28,52,0,0,0,0,0,0,0,1124,308,241,60,43,17,7,816,272,230,72,158,314,0,201700
14000US06037203100,140,6,37,1195,360,335,161,174,20,154,0,25,0,14,0,14,11,835,420,164,256,54,202,0,415,122,173,28,145,120,0,203100
14000US06037203200,140,6,37,1232,325,291,103,168,42,126,20,34,24,0,0,0,10,907,447,306,141,54,87,0,460,204,63,19,44,193,0,203200
14000US06037203300,140,6,37,477,54,46,19,27,0,27,0,8,0,0,0,0,8,423,113,56,57,13,44,0,310,49,70,11,59,191,0,203300
14000US06037203500,140,6,37,896,134,116,55,61,13,48,0,18,8,4,4,0,6,762,258,134,124,35,89,0,504,132,124,65,59,248,0,203500
14000US06037203600,140,6,37,1315,254,178,32,146,31,115,0,76,25,7,0,7,44,1061,436,270,158,7,151,8,625,81,175,35,140,369,0,203600
14000US06037203710,140,6,37,824,180,133,25,108,44,64,0,47,5,30,6,24,12,644,299,171,128,30,98,0,345,73,119,32,87,153,0,203710
14000US06037203720,140,6,37,1037,208,176,107,69,30,39,0,32,0,0,0,0,32,829,357,218,139,58,81,0,472,226,91,45,46,155,0,203720
14000US06037203800,140,6,37,1049,181,162,99,63,0,63,0,19,0,11,0,11,8,868,549,395,154,85,69,0,319,56,68,6,62,195,0,203800
14000US06037203900,140,6,37,692,102,55,17,38,9,29,0,47,10,37,0,37,0,590,300,129,171,78,93,0,290,90,89,19,70,111,0,203900
14000US06037204110,140,6,37,792,120,106,36,70,4,66,0,14,0,9,0,9,5,672,254,167,87,59,28,0,418,189,108,31,77,121,0,204110
14000US06037204120,140,6,37,660,86,55,4,51,0,51,0,31,10,0,0,0,21,574,296,218,78,26,52,0,278,95,74,36,38,109,0,204120
14000US06037204200,140,6,37,817,156,128,36,92,28,64,0,28,11,0,0,0,17,661,268,132,136,50,86,0,393,46,60,43,17,287,0,204200
14000US06037204300,140,6,37,1279,191,164,76,88,7,81,0,27,6,9,0,9,12,1088,455,159,296,68,228,0,633,203,185,80,105,245,0,204300
14000US06037204410,140,6,37,590,126,113,28,85,21,64,0,13,0,0,0,0,13,464,226,117,109,40,69,0,238,63,52,0,52,123,0,204410
14000US06037204420,140,6,37,844,190,175,63,112,46,66,0,15,0,0,0,0,15,654,257,150,107,37,70,0,397,77,65,25,40,255,0,204420
14000US06037204600,140,6,37,1039,123,98,61,37,0,37,0,25,16,9,9,0,0,916,507,318,189,108,81,0,409,187,68,31,37,154,0,204600
14000US06037204700,140,6,37,1122,149,103,37,66,15,51,0,46,46,0,0,0,0,973,431,283,148,9,139,0,542,264,130,101,29,148,0,204700
14000US06037204810,140,6,37,1072,102,79,10,69,0,69,0,23,23,0,0,0,0,970,489,301,188,32,156,0,481,167,115,38,77,199,0,204810
14000US06037204820,140,6,37,537,116,98,39,59,31,28,0,18,0,0,0,0,18,421,170,123,47,8,39,0,251,132,44,32,12,75,0,204820
14000US06037204910,140,6,37,740,112,96,54,42,19,23,0,16,0,10,0,10,6,628,289,152,137,5,132,0,339,199,81,65,16,59,0,204910
14000US06037204920,140,6,37,603,37,17,6,11,11,0,0,20,20,0,0,0,0,566,299,135,164,67,97,0,267,134,88,24,64,45,0,204920
14000US06037205110,140,6,37,809,204,178,88,90,13,77,0,26,0,0,0,0,26,605,390,207,176,26,150,7,215,43,97,51,46,75,0,205110
14000US06037205120,140,6,37,916,124,85,32,53,8,45,0,39,10,5,0,5,24,792,462,215,247,23,224,0,330,111,87,38,49,132,0,205120
14000US06037206010,140,6,37,952,94,47,6,41,0,41,0,47,6,18,0,18,23,858,269,136,133,0,133,0,589,147,165,47,118,277,0,206010
14000US06037206020,140,6,37,218,0,0,0,0,0,0,0,0,0,0,0,0,0,218,7,4,3,0,3,0,211,80,25,11,14,106,0,206020
14000US06037206031,140,6,37,1631,70,0,0,0,0,0,0,70,0,0,0,0,70,1561,125,104,21,12,9,0,1436,300,35,16,19,1101,0,206031
14000US06037206032,140,6,37,1572,296,238,82,156,26,130,0,58,0,23,0,23,35,1276,498,254,244,31,213,0,778,164,118,42,76,496,0,206032
14000US06037206050,140,6,37,756,187,123,23,100,4,96,0,64,48,0,0,0,16,569,180,126,54,0,54,0,389,146,9,0,9,234,0,206050
14000US06037206200,140,6,37,1578,252,23,0,23,0,23,0,229,19,0,0,0,210,1326,51,0,51,0,51,0,1275,186,40,18,22,1049,0,206200
14000US06037206300,140,6,37,2117,591,0,0,0,0,0,0,591,0,0,0,0,591,1526,0,0,0,0,0,0,1526,0,15,0,15,1511,0,206300
14000US06037207101,140,6,37,1267,27,9,0,9,0,9,0,18,6,12,12,0,0,1240,179,126,36,0,36,17,1061,314,104,38,66,643,0,207101
14000US06037207102,140,6,37,938,36,13,13,0,0,0,0,23,0,23,0,23,0,902,276,217,59,32,27,0,626,129,20,18,2,477,0,207102
14000US06037207103,140,6,37,805,92,71,50,21,0,21,0,21,8,0,0,0,13,713,188,174,14,14,0,0,525,139,37,5,32,349,0,207103
14000US06037207301,140,6,37,3295,470,0,0,0,0,0,0,470,0,0,0,0,470,2825,40,0,40,40,0,0,2785,192,0,0,0,2593,0,207301
14000US06037207302,140,6,37,2536,223,0,0,0,0,0,0,223,21,0,0,0,202,2313,148,0,148,119,29,0,2165,231,16,16,0,1918,0,207302
14000US06037207400,140,6,37,18,0,0,0,0,0,0,0,0,0,0,0,0,0,18,0,0,0,0,0,0,18,0,0,0,0,18,0,207400
14000US06037207501,140,6,37,1339,16,7,0,7,7,0,0,9,0,0,0,0,9,1323,91,20,71,57,14,0,1232,138,51,51,0,1043,0,207501
14000US06037207502,140,6,37,1709,7,0,0,0,0,0,0,7,0,0,0,0,7,1702,25,25,0,0,0,0,1677,278,0,0,0,1399,0,207502
14000US06037207710,140,6,37,1727,79,16,0,16,0,16,0,63,0,0,0,0,63,1648,69,36,33,0,33,0,1579,247,0,0,0,1332,0,207710
14000US06037207900,140,6,37,2141,49,23,0,23,0,23,0,26,10,0,0,0,16,2092,303,224,70,26,44,9,1789,443,51,41,10,1295,0,207900
14000US06037208000,140,6,37,2289,320,306,49,257,69,188,0,14,0,0,0,0,14,1969,618,280,338,23,315,0,1351,169,201,72,129,981,0,208000
14000US06037208301,140,6,37,517,86,86,40,46,6,40,0,0,0,0,0,0,0,431,263,130,133,63,70,0,168,48,22,22,0,98,0,208301
14000US06037208302,140,6,37,1587,398,266,107,159,0,159,0,132,4,0,0,0,128,1189,350,203,147,49,98,0,839,237,82,30,52,520,0,208302
14000US06037208401,140,6,37,1461,147,128,73,55,18,37,0,19,19,0,0,0,0,1314,466,151,315,123,192,0,848,235,228,98,130,385,0,208401
14000US06037208402,140,6,37,859,151,118,58,60,0,60,0,33,4,18,0,18,11,708,258,142,116,55,61,0,450,176,81,34,47,193,0,208402
14000US06037208501,140,6,37,829,110,110,37,73,0,73,0,0,0,0,0,0,0,719,169,85,84,20,64,0,550,154,94,24,70,302,0,208501
14000US06037208502,140,6,37,1227,132,132,46,86,6,80,0,0,0,0,0,0,0,1095,369,163,206,85,121,0,726,196,98,23,75,432,0,208502
14000US06037208610,140,6,37,1318,125,118,0,118,0,118,0,7,0,7,7,0,0,1193,326,186,140,46,94,0,867,297,192,60,132,378,0,208610
14000US06037208620,140,6,37,1721,192,144,52,92,16,76,0,48,19,10,0,10,19,1529,501,316,176,80,96,9,1028,266,202,36,166,560,0,208620
14000US06037208710,140,6,37,1781,151,95,34,61,8,53,0,56,11,0,0,0,45,1630,359,178,162,29,133,19,1271,321,133,58,75,817,0,208710
14000US06037208720,140,6,37,1510,246,199,89,110,0,110,0,47,4,25,7,18,18,1264,340,119,217,38,179,4,924,201,162,89,73,561,0,208720
14000US06037208801,140,6,37,1227,102,92,39,53,0,53,0,10,0,0,0,0,10,1125,232,102,130,87,43,0,893,157,140,74,66,596,0,208801
14000US06037208802,140,6,37,1323,27,10,10,0,0,0,0,17,0,9,0,9,8,1296,227,121,106,24,82,0,1069,180,139,32,107,750,0,208802
14000US06037208902,140,6,37,557,41,41,12,29,0,29,0,0,0,0,0,0,0,516,185,65,120,70,50,0,331,59,67,18,49,205,0,208902
14000US06037208903,140,6,37,1145,132,88,0,88,20,68,0,44,0,0,0,0,44,1013,265,97,168,95,73,0,748,95,105,80,25,548,0,208903
14000US06037208904,140,6,37,1218,178,97,72,25,10,15,0,81,9,0,0,0,72,1040,357,226,131,47,84,0,683,133,21,0,21,529,0,208904
14000US06037209102,140,6,37,1816,256,168,50,87,0,87,31,88,29,21,0,21,38,1560,509,276,233,144,89,0,1051,204,114,74,40,733,0,209102
14000US06037209103,140,6,37,985,125,113,24,89,68,21,0,12,0,0,0,0,12,860,408,219,189,86,103,0,452,120,96,25,71,236,0,209103
14000US06037209104,140,6,37,852,80,38,32,6,0,6,0,42,5,4,4,0,33,772,139,106,33,7,26,0,633,115,63,16,47,455,0,209104
14000US06037209200,140,6,37,1233,58,47,0,47,28,19,0,11,0,11,0,11,0,1175,162,79,83,56,27,0,1013,119,48,25,23,846,0,209200
14000US06037209300,140,6,37,1898,258,153,63,90,39,51,0,105,0,31,13,18,74,1640,352,182,154,0,154,16,1288,174,197,91,106,917,0,209300
14000US06037209401,140,6,37,1324,141,80,46,34,17,17,0,61,16,0,0,0,45,1183,428,170,258,98,160,0,755,101,120,35,85,534,0,209401
14000US06037209402,140,6,37,1146,106,99,34,65,27,38,0,7,7,0,0,0,0,1040,355,72,271,150,121,12,685,117,192,117,75,376,0,209402
14000US06037209403,140,6,37,1293,84,55,19,36,14,22,0,29,11,0,0,0,18,1209,349,151,198,87,111,0,860,230,31,31,0,599,0,209403
14000US06037209510,140,6,37,934,98,60,35,25,10,15,0,38,0,8,8,0,30,836,198,106,86,37,49,6,638,196,80,25,55,362,0,209510
14000US06037209520,140,6,37,869,81,64,28,36,15,21,0,17,0,5,0,5,12,788,257,138,119,9,110,0,531,101,77,54,23,353,0,209520
14000US06037209810,140,6,37,675,74,53,18,35,15,20,0,21,0,12,0,12,9,601,244,81,163,78,85,0,357,27,157,84,73,173,0,209810
14000US06037209820,140,6,37,760,91,78,27,51,0,51,0,13,0,13,0,13,0,669,260,102,158,79,79,0,409,92,66,15,51,251,0,209820
14000US06037210010,140,6,37,1212,268,168,89,79,0,79,0,100,31,0,0,0,69,944,223,105,118,22,96,0,721,89,62,21,41,570,0,210010
14000US06037211000,140,6,37,1662,12,12,12,0,0,0,0,0,0,0,0,0,0,1650,457,384,73,27,46,0,1193,506,101,59,42,586,0,211000
14000US06037211120,140,6,37,2550,44,44,10,34,0,34,0,0,0,0,0,0,0,2506,318,200,118,17,101,0,2188,528,277,182,95,1383,0,211120
14000US06037211121,140,6,37,907,74,60,49,11,0,11,0,14,0,9,0,9,5,833,45,25,20,12,8,0,788,216,118,13,105,454,0,211121
14000US06037211122,140,6,37,1189,51,33,0,33,0,33,0,18,10,0,0,0,8,1138,297,195,102,0,102,0,841,153,37,6,31,651,0,211122
14000US06037211201,140,6,37,906,122,103,15,81,25,56,7,19,12,0,0,0,7,784,290,165,125,32,93,0,494,113,68,29,39,313,0,211201
14000US06037211202,140,6,37,922,139,100,31,69,0,69,0,39,23,8,0,8,8,783,178,91,87,19,68,0,605,77,105,25,80,423,0,211202
14000US06037211310,140,6,37,1313,158,142,76,66,19,47,0,16,0,0,0,0,16,1155,383,160,223,87,136,0,772,176,104,27,77,492,0,211310
14000US06037211320,140,6,37,1198,129,111,85,26,16,10,0,18,0,6,6,0,12,1069,340,116,224,90,134,0,729,163,163,44,119,403,0,211320
14000US06037211410,140,6,37,1141,84,47,12,35,0,35,0,37,0,18,0,18,19,1057,242,193,49,13,36,0,815,227,127,20,107,461,0,211410
14000US06037211420,140,6,37,1277,145,85,14,71,0,71,0,60,13,0,0,0,47,1132,278,128,150,48,102,0,854,216,59,22,37,579,0,211420
14000US06037211500,140,6,37,1841,109,75,38,37,0,37,0,34,0,26,13,13,8,1732,544,371,173,22,151,0,1188,462,155,81,74,571,0,211500
14000US06037211701,140,6,37,1129,31,23,12,11,0,11,0,8,8,0,0,0,0,1098,485,419,66,10,56,0,613,221,69,0,69,323,0,211701
14000US06037211703,140,6,37,1998,81,35,14,21,0,21,0,46,8,28,0,28,10,1917,526,332,181,92,89,13,1391,438,248,120,128,705,0,211703
14000US06037211704,140,6,37,1580,60,30,0,30,11,19,0,30,11,10,0,10,9,1520,217,194,23,15,8,0,1303,316,68,42,26,919,0,211704
14000US06037211802,140,6,37,2164,88,24,2,22,22,0,0,64,23,7,7,0,34,2076,386,149,237,0,237,0,1690,306,149,72,77,1235,0,211802
14000US06037211803,140,6,37,1634,52,47,12,35,0,35,0,5,0,0,0,0,5,1582,519,217,302,94,208,0,1063,251,119,100,19,693,0,211803
14000US06037211804,140,6,37,1320,80,70,24,46,0,46,0,10,0,0,0,0,10,1240,229,229,0,0,0,0,1011,314,153,37,116,544,0,211804
14000US06037211910,140,6,37,1709,65,45,22,23,16,7,0,20,0,14,0,14,6,1644,452,214,238,87,151,0,1192,229,175,68,107,788,0,211910
14000US06037211921,140,6,37,995,32,24,6,0,0,0,18,8,8,0,0,0,0,963,138,83,55,18,37,0,825,259,101,59,42,465,0,211921
14000US06037211922,140,6,37,1346,129,97,55,42,0,42,0,32,20,0,0,0,12,1217,361,136,225,82,143,0,856,118,213,104,109,525,0,211922
14000US06037212101,140,6,37,1184,37,22,22,0,0,0,0,15,15,0,0,0,0,1147,105,69,36,15,21,0,1042,131,125,51,74,786,0,212101
14000US06037212102,140,6,37,1287,35,20,20,0,0,0,0,15,7,0,0,0,8,1252,104,3,101,40,61,0,1148,128,148,60,88,872,0,212102
14000US06037212202,140,6,37,1147,81,65,42,23,6,17,0,16,0,16,0,16,0,1066,365,172,193,80,113,0,701,120,182,113,69,399,0,212202
14000US06037212203,140,6,37,1076,86,86,17,69,12,57,0,0,0,0,0,0,0,990,229,78,151,28,123,0,761,175,188,117,71,398,0,212203
14000US06037212204,140,6,37,1204,126,126,24,102,55,47,0,0,0,0,0,0,0,1078,439,165,261,84,177,13,639,134,117,87,30,388,0,212204
14000US06037212303,140,6,37,1174,133,106,24,82,40,42,0,27,0,27,27,0,0,1041,262,105,155,66,89,2,779,83,172,103,69,524,0,212303
14000US06037212304,140,6,37,804,67,40,28,12,0,12,0,27,0,15,15,0,12,737,183,51,132,41,91,0,554,86,18,18,0,450,0,212304
14000US06037212305,140,6,37,1019,147,78,26,39,0,39,13,69,13,21,0,21,35,872,315,172,137,37,100,6,557,74,76,36,40,407,0,212305
14000US06037212306,140,6,37,1160,66,47,16,31,13,18,0,19,0,19,0,19,0,1094,273,154,119,0,119,0,821,246,222,47,175,353,0,212306
14000US06037212410,140,6,37,1593,75,75,40,28,0,28,7,0,0,0,0,0,0,1518,422,233,189,62,127,0,1096,202,178,129,49,716,0,212410
14000US06037212420,140,6,37,1247,88,80,19,61,25,36,0,8,0,0,0,0,8,1159,314,155,159,79,80,0,845,230,123,63,60,492,0,212420
14000US06037212501,140,6,37,949,57,40,25,15,0,15,0,17,0,5,0,5,12,892,191,105,86,38,48,0,701,106,80,0,80,515,0,212501
14000US06037212502,140,6,37,1230,65,39,31,8,0,8,0,26,0,0,0,0,26,1165,194,53,122,75,47,19,971,223,166,33,133,582,0,212502
14000US06037212610,140,6,37,1820,27,5,5,0,0,0,0,22,0,10,10,0,12,1793,385,262,123,63,60,0,1408,327,122,72,50,959,0,212610
14000US06037212620,140,6,37,1743,113,82,28,54,21,33,0,31,8,10,0,10,13,1630,481,308,173,28,145,0,1149,279,204,96,108,666,0,212620
14000US06037212701,140,6,37,763,15,15,4,11,0,11,0,0,0,0,0,0,0,748,218,198,20,0,20,0,530,240,106,30,76,184,0,212701
14000US06037212702,140,6,37,1492,7,0,0,0,0,0,0,7,0,0,0,0,7,1485,345,265,80,37,43,0,1140,274,217,120,97,649,0,212702
14000US06037212800,140,6,37,1335,179,122,25,97,0,97,0,57,32,16,0,16,9,1156,250,224,26,0,26,0,906,317,161,50,111,428,0,212800
14000US06037212900,140,6,37,1491,227,167,55,112,22,90,0,60,8,6,6,0,46,1264,289,164,125,41,84,0,975,236,268,151,117,471,0,212900
14000US06037213100,140,6,37,958,111,58,0,58,42,16,0,53,53,0,0,0,0,847,284,181,103,15,88,0,563,226,109,52,57,228,0,213100
14000US06037213201,140,6,37,1475,75,61,11,50,8,42,0,14,6,8,0,8,0,1400,446,263,183,51,132,0,954,328,245,115,130,381,0,213201
14000US06037213202,140,6,37,1296,110,55,32,23,0,23,0,55,8,25,25,0,22,1186,300,209,91,19,72,0,886,412,128,64,64,346,0,213202
14000US06037213310,140,6,37,1142,123,98,39,59,17,42,0,25,6,19,0,19,0,1019,384,211,153,87,66,20,635,264,156,78,78,215,0,213310
14000US06037213320,140,6,37,921,70,38,28,10,5,5,0,32,5,0,0,0,27,851,153,93,60,20,40,0,698,162,74,29,45,462,0,213320
14000US06037213401,140,6,37,1745,122,102,64,38,12,26,0,20,13,0,0,0,7,1623,456,240,216,142,74,0,1167,263,314,180,134,590,0,213401
14000US06037213402,140,6,37,1515,85,67,15,52,10,42,0,18,0,8,0,8,10,1430,492,307,185,55,130,0,938,255,224,153,71,459,0,213402
14000US06037214000,140,6,37,1389,23,11,11,0,0,0,0,12,0,0,0,0,12,1366,366,349,17,0,17,0,1000,343,53,32,21,604,0,214000
14000US06037214100,140,6,37,1672,0,0,0,0,0,0,0,0,0,0,0,0,0,1672,367,332,35,0,35,0,1305,502,63,23,40,740,0,214100
14000US06037214400,140,6,37,1641,31,31,31,0,0,0,0,0,0,0,0,0,0,1610,110,86,24,18,6,0,1500,239,10,10,0,1251,0,214400
14000US06037214501,140,6,37,1525,10,0,0,0,0,0,0,10,0,0,0,0,10,1515,240,176,64,26,38,0,1275,311,56,0,56,908,0,214501
14000US06037214502,140,6,37,2479,37,0,0,0,0,0,0,37,0,37,37,0,0,2442,368,233,135,46,89,0,2074,457,148,60,88,1469,0,214502
14000US06037214503,140,6,37,1522,7,0,0,0,0,0,0,7,0,7,0,7,0,1515,426,308,118,42,76,0,1089,167,111,41,70,811,0,214503
14000US06037214600,140,6,37,1310,15,0,0,0,0,0,0,15,9,0,0,0,6,1295,98,89,9,9,0,0,1197,257,71,0,71,869,0,214600
14000US06037214700,140,6,37,1223,0,0,0,0,0,0,0,0,0,0,0,0,0,1223,150,109,41,6,35,0,1073,280,130,81,49,663,0,214700
14000US06037214800,140,6,37,1352,54,0,0,0,0,0,0,54,0,0,0,0,54,1298,187,145,42,42,0,0,1111,213,74,10,64,824,0,214800
14000US06037214901,140,6,37,2038,0,0,0,0,0,0,0,0,0,0,0,0,0,2038,21,12,9,0,9,0,2017,335,39,0,39,1643,0,214901
14000US06037214902,140,6,37,1519,10,0,0,0,0,0,0,10,0,0,0,0,10,1509,91,69,22,0,22,0,1418,231,27,0,27,1160,0,214902
14000US06037215101,140,6,37,1542,51,5,5,0,0,0,0,46,0,8,0,8,38,1491,113,51,62,0,62,0,1378,196,43,13,30,1139,0,215101
14000US06037215102,140,6,37,2033,14,0,0,0,0,0,0,14,0,0,0,0,14,2019,126,60,66,0,66,0,1893,222,87,68,19,1584,0,215102
14000US06037216100,140,6,37,986,18,18,18,0,0,0,0,0,0,0,0,0,0,968,313,219,94,42,52,0,655,176,32,12,20,447,0,216100
14000US06037216200,140,6,37,2556,27,11,0,11,0,11,0,16,0,0,0,0,16,2529,388,214,174,81,93,0,2141,422,59,16,43,1660,0,216200
14000US06037216300,140,6,37,2461,33,0,0,0,0,0,0,33,0,0,0,0,33,2428,418,274,144,45,99,0,2010,419,199,67,132,1392,0,216300
14000US06037216401,140,6,37,2121,90,54,54,0,0,0,0,36,0,11,0,11,25,2031,387,322,36,0,36,29,1644,314,77,0,77,1253,0,216401
14000US06037216402,140,6,37,1421,9,0,0,0,0,0,0,9,0,5,5,0,4,1412,130,130,0,0,0,0,1282,192,120,92,28,970,0,216402
14000US06037216700,140,6,37,1640,86,69,7,62,0,62,0,17,0,0,0,0,17,1554,380,195,185,77,108,0,1174,297,116,44,72,761,0,216700
14000US06037216800,140,6,37,1533,22,0,0,0,0,0,0,22,0,14,0,14,8,1511,378,355,12,0,12,11,1133,260,100,40,60,773,0,216800
14000US06037216900,140,6,37,2534,144,67,53,14,0,14,0,77,18,32,17,15,27,2390,346,267,79,0,79,0,2044,360,140,39,101,1544,0,216900
14000US06037217001,140,6,37,1034,79,12,12,0,0,0,0,67,0,0,0,0,67,955,290,235,55,12,43,0,665,240,17,0,17,408,0,217001
14000US06037217002,140,6,37,2233,13,0,0,0,0,0,0,13,0,0,0,0,13,2220,430,366,64,0,64,0,1790,484,90,42,48,1216,0,217002
14000US06037217100,140,6,37,2225,188,131,34,97,0,97,0,57,14,0,0,0,43,2037,657,308,349,143,206,0,1380,354,186,84,102,840,0,217100
14000US06037217200,140,6,37,1532,18,7,0,7,0,7,0,11,11,0,0,0,0,1514,488,289,199,56,143,0,1026,194,151,48,103,681,0,217200
14000US06037218110,140,6,37,1263,119,82,27,38,0,38,17,37,0,8,0,8,29,1144,309,177,121,26,95,11,835,262,187,29,158,386,0,218110
14000US06037218120,140,6,37,1438,272,246,102,144,29,115,0,26,0,13,0,13,13,1166,392,173,219,16,203,0,774,178,160,99,61,436,0,218120
14000US06037218210,140,6,37,1116,92,65,17,48,6,42,0,27,0,15,0,15,12,1024,495,192,303,141,162,0,529,119,92,14,78,318,0,218210
14000US06037218220,140,6,37,1528,85,72,30,42,0,42,0,13,0,0,0,0,13,1443,514,328,186,46,140,0,929,154,268,59,209,507,0,218220
14000US06037218300,140,6,37,2016,231,152,41,111,20,91,0,79,30,37,0,37,12,1785,579,272,272,61,211,35,1206,223,251,71,180,732,0,218300
14000US06037218400,140,6,37,1509,129,90,26,64,0,64,0,39,0,9,0,9,30,1380,501,260,217,66,151,24,879,146,218,70,148,515,0,218400
14000US06037218500,140,6,37,1048,150,115,5,110,35,75,0,35,5,5,5,0,25,898,359,209,150,48,102,0,539,86,147,40,107,306,0,218500
14000US06037218600,140,6,37,1089,180,119,31,88,39,49,0,61,36,0,0,0,25,909,374,149,225,71,154,0,535,145,123,54,69,267,0,218600
14000US06037218701,140,6,37,797,121,102,26,76,0,76,0,19,0,19,0,19,0,676,138,99,39,0,39,0,538,109,138,62,76,291,0,218701
14000US06037218702,140,6,37,801,101,73,20,53,11,42,0,28,12,7,0,7,9,700,205,79,126,46,80,0,495,105,118,65,53,272,0,218702
14000US06037218800,140,6,37,817,120,94,26,68,9,59,0,26,0,16,9,7,10,697,185,60,125,52,73,0,512,127,140,70,70,245,0,218800
14000US06037218900,140,6,37,1958,312,241,58,173,49,124,10,71,11,0,0,0,60,1646,629,336,293,83,210,0,1017,134,147,64,83,736,0,218900
14000US06037219010,140,6,37,775,195,151,34,117,28,89,0,44,16,12,0,12,16,580,169,116,53,26,27,0,411,101,141,62,79,169,0,219010
14000US06037219020,140,6,37,1267,172,93,53,40,0,40,0,79,7,12,0,12,60,1095,373,247,98,0,98,28,722,117,178,75,103,427,0,219020
14000US06037219300,140,6,37,1413,178,114,50,64,0,64,0,64,10,44,28,16,10,1235,357,276,81,0,81,0,878,95,237,41,196,546,0,219300
14000US06037219500,140,6,37,710,112,69,21,48,10,38,0,43,29,0,0,0,14,598,97,42,55,18,37,0,501,164,89,27,62,248,0,219500
14000US06037219700,140,6,37,1405,191,56,22,34,0,34,0,135,0,33,0,33,102,1214,458,344,90,21,69,24,756,189,174,75,99,393,0,219700
14000US06037219800,140,6,37,958,154,105,27,78,27,51,0,49,14,0,0,0,35,804,347,131,197,68,129,19,457,167,75,39,36,215,0,219800
14000US06037219901,140,6,37,1385,201,138,55,83,12,71,0,63,8,45,24,21,10,1184,618,343,275,51,224,0,566,159,103,60,43,304,0,219901
14000US06037219902,140,6,37,1218,142,95,62,33,0,33,0,47,15,0,0,0,32,1076,453,305,148,57,91,0,623,186,145,31,114,292,0,219902
14000US06037220000,140,6,37,2005,234,159,26,133,22,111,0,75,0,28,28,0,47,1771,675,396,279,121,158,0,1096,100,185,0,185,811,0,220000
14000US06037220100,140,6,37,1030,150,124,53,71,51,20,0,26,0,0,0,0,26,880,187,48,124,0,124,15,693,164,61,17,44,468,0,220100
14000US06037221110,140,6,37,1075,58,49,15,34,20,14,0,9,0,0,0,0,9,1017,459,216,243,61,182,0,558,105,190,96,94,263,0,221110
14000US06037221120,140,6,37,823,87,75,40,26,0,26,9,12,0,0,0,0,12,736,261,84,177,100,77,0,475,114,182,106,76,179,0,221120
14000US06037221210,140,6,37,895,78,40,20,20,0,20,0,38,0,8,0,8,30,817,368,143,225,76,149,0,449,128,114,61,53,207,0,221210
14000US06037221220,140,6,37,1027,126,126,62,64,9,55,0,0,0,0,0,0,0,901,307,142,165,62,103,0,594,178,135,37,98,281,0,221220
14000US06037221302,140,6,37,1265,213,159,89,70,63,7,0,54,0,35,7,28,19,1052,385,162,223,58,165,0,667,84,262,62,200,321,0,221302
14000US06037221303,140,6,37,750,76,67,29,38,16,22,0,9,0,9,0,9,0,674,259,147,112,12,100,0,415,119,83,40,43,213,0,221303
14000US06037221304,140,6,37,1112,212,167,90,77,0,77,0,45,9,0,0,0,36,900,368,150,218,38,180,0,532,131,126,50,76,275,0,221304
14000US06037221401,140,6,37,1335,137,119,0,119,0,119,0,18,0,8,0,8,10,1198,257,85,172,67,105,0,941,215,86,18,68,640,0,221401
14000US06037221402,140,6,37,948,151,122,6,116,16,100,0,29,9,13,0,13,7,797,196,100,96,32,64,0,601,208,79,65,14,314,0,221402
14000US06037221500,140,6,37,1188,276,188,55,133,0,133,0,88,10,46,0,46,32,912,206,106,100,22,78,0,706,143,122,75,47,441,0,221500
14000US06037221601,140,6,37,898,162,126,33,93,22,71,0,36,9,0,0,0,27,736,237,143,94,8,86,0,499,184,132,62,70,183,0,221601
14000US06037221602,140,6,37,806,231,167,75,92,22,70,0,64,0,38,21,17,26,575,258,123,135,52,83,0,317,71,114,10,104,132,0,221602
14000US06037221710,140,6,37,884,145,132,82,50,18,32,0,13,5,8,0,8,0,739,189,73,116,62,54,0,550,107,65,16,49,378,0,221710
14000US06037221810,140,6,37,889,61,37,14,23,0,23,0,24,0,0,0,0,24,828,132,92,40,7,33,0,696,66,41,11,30,589,0,221810
14000US06037221820,140,6,37,1011,43,7,7,0,0,0,0,36,0,7,0,7,29,968,112,84,28,0,28,0,856,58,46,29,17,752,0,221820
14000US06037221900,140,6,37,920,49,46,42,4,0,4,0,3,0,3,0,3,0,871,129,110,19,19,0,0,742,65,47,24,23,630,0,221900
14000US06037222001,140,6,37,868,114,91,0,91,0,91,0,23,0,18,13,5,5,754,308,209,99,21,78,0,446,126,74,12,62,246,0,222001
14000US06037222002,140,6,37,1220,111,88,0,88,0,88,0,23,23,0,0,0,0,1109,426,325,101,0,101,0,683,169,225,75,150,289,0,222002
14000US06037222100,140,6,37,1119,196,150,48,102,15,87,0,46,0,0,0,0,46,923,282,167,115,0,115,0,641,236,106,26,80,299,0,222100
14000US06037222200,140,6,37,1156,218,172,23,149,0,149,0,46,0,21,0,21,25,938,305,148,157,89,68,0,633,86,80,45,35,467,0,222200
14000US06037222500,140,6,37,1329,192,163,63,100,0,100,0,29,0,23,13,10,6,1137,506,324,182,32,150,0,631,202,165,60,105,264,0,222500
14000US06037222600,140,6,37,1469,181,143,32,111,21,90,0,38,28,10,0,10,0,1288,433,235,198,49,149,0,855,173,146,37,109,536,0,222600
14000US06037222700,140,6,37,160,0,0,0,0,0,0,0,0,0,0,0,0,0,160,0,0,0,0,0,0,160,0,10,10,0,150,0,222700
14000US06037224010,140,6,37,1043,303,161,39,122,0,122,0,142,8,7,0,7,127,740,81,52,29,0,29,0,659,95,14,14,0,550,0,224010
14000US06037224020,140,6,37,805,213,158,26,120,46,74,12,55,17,16,16,0,22,592,142,98,44,20,24,0,450,62,55,6,49,333,0,224020
14000US06037224200,140,6,37,668,93,79,47,32,0,32,0,14,0,0,0,0,14,575,194,99,95,21,74,0,381,90,87,35,52,204,0,224200
14000US06037224310,140,6,37,636,90,63,24,39,11,28,0,27,0,11,0,11,16,546,200,107,93,43,50,0,346,46,59,31,28,241,0,224310
14000US06037224320,140,6,37,979,172,144,31,113,20,93,0,28,0,11,0,11,17,807,269,95,174,25,149,0,538,102,135,68,67,301,0,224320
14000US06037224410,140,6,37,1059,68,68,0,68,24,44,0,0,0,0,0,0,0,991,192,73,119,46,73,0,799,180,19,9,10,600,0,224410
14000US06037224420,140,6,37,717,92,73,24,49,24,25,0,19,0,12,0,12,7,625,154,53,101,57,44,0,471,47,104,37,67,320,0,224420
14000US06037224600,140,6,37,820,236,215,78,137,70,67,0,21,0,0,0,0,21,584,278,143,135,30,105,0,306,113,83,45,38,110,0,224600
14000US06037224700,140,6,37,889,23,18,18,0,0,0,0,5,0,0,0,0,5,866,30,6,24,0,24,0,836,30,44,12,32,762,0,224700
14000US06037226001,140,6,37,477,101,97,78,19,7,12,0,4,0,4,0,4,0,376,109,69,40,15,25,0,267,98,21,16,5,148,0,226001
14000US06037226002,140,6,37,787,85,14,3,11,0,11,0,71,7,0,0,0,64,702,90,57,33,25,8,0,612,58,22,22,0,532,0,226002
14000US06037226410,140,6,37,793,224,169,58,111,11,100,0,55,13,0,0,0,42,569,346,166,174,91,83,6,223,106,55,31,24,62,0,226410
14000US06037226420,140,6,37,1178,284,272,150,122,7,115,0,12,0,0,0,0,12,894,412,288,124,0,124,0,482,141,172,35,137,169,0,226420
14000US06037226700,140,6,37,1279,266,242,73,169,42,127,0,24,2,22,0,22,0,1013,598,223,375,121,254,0,415,145,93,53,40,177,0,226700
14000US06037227010,140,6,37,995,320,277,83,194,15,179,0,43,0,28,0,28,15,675,432,249,183,32,151,0,243,51,77,28,49,115,0,227010
14000US06037227020,140,6,37,664,130,121,54,67,11,56,0,9,0,9,0,9,0,534,397,251,146,41,105,0,137,50,56,32,24,31,0,227020
14000US06037228100,140,6,37,976,268,268,79,189,26,163,0,0,0,0,0,0,0,708,367,171,196,61,135,0,341,118,84,70,14,139,0,228100
14000US06037228210,140,6,37,871,161,120,47,73,16,57,0,41,0,16,0,16,25,710,274,130,144,40,104,0,436,102,108,33,75,226,0,228210
14000US06037228220,140,6,37,904,254,222,55,167,40,127,0,32,0,4,0,4,28,650,378,200,178,50,128,0,272,114,65,12,53,93,0,228220
14000US06037228310,140,6,37,857,202,186,80,106,8,98,0,16,0,0,0,0,16,655,358,130,228,104,124,0,297,130,59,34,25,108,0,228310
14000US06037228320,140,6,37,720,219,186,19,167,22,145,0,33,21,7,0,7,5,501,243,114,129,42,87,0,258,78,87,58,29,93,0,228320
14000US06037228410,140,6,37,715,208,197,32,165,51,114,0,11,0,11,0,11,0,507,271,158,113,25,88,0,236,94,79,36,43,63,0,228410
14000US06037228420,140,6,37,683,130,125,31,94,27,67,0,5,5,0,0,0,0,553,349,151,198,63,135,0,204,52,51,13,38,101,0,228420
14000US06037228500,140,6,37,1116,253,231,90,141,34,107,0,22,0,8,8,0,14,863,422,223,190,45,145,9,441,145,113,57,56,183,0,228500
14000US06037228600,140,6,37,986,331,314,113,201,81,120,0,17,0,17,0,17,0,655,316,151,165,82,83,0,339,49,110,39,71,180,0,228600
14000US06037228710,140,6,37,957,297,272,68,198,6,192,6,25,25,0,0,0,0,660,291,119,169,44,125,3,369,43,145,38,107,181,0,228710
14000US06037228720,140,6,37,976,166,150,48,102,61,41,0,16,0,16,0,16,0,810,500,224,276,98,178,0,310,100,81,30,51,129,0,228720
14000US06037228800,140,6,37,1195,353,338,156,182,28,154,0,15,0,9,0,9,6,842,407,225,182,49,133,0,435,173,142,20,122,120,0,228800
14000US06037228900,140,6,37,772,264,235,139,96,0,96,0,29,0,0,0,0,29,508,192,73,119,18,101,0,316,51,120,18,102,145,0,228900
14000US06037229100,140,6,37,905,122,115,70,45,30,15,0,7,0,7,0,7,0,783,431,262,169,84,85,0,352,119,106,72,34,127,0,229100
14000US06037229200,140,6,37,1104,233,221,106,115,0,115,0,12,0,0,0,0,12,871,301,121,180,60,120,0,570,71,138,26,112,361,0,229200
14000US06037229300,140,6,37,1189,350,310,175,135,17,118,0,40,9,9,0,9,22,839,449,220,229,90,139,0,390,63,157,68,89,170,0,229300
14000US06037229410,140,6,37,743,148,119,84,35,23,12,0,29,15,1,1,0,13,595,391,192,199,71,128,0,204,81,79,16,63,44,0,229410
14000US06037229420,140,6,37,951,245,234,97,137,23,114,0,11,0,0,0,0,11,706,382,239,143,80,63,0,324,119,97,40,57,108,0,229420
14000US06037231100,140,6,37,607,163,133,21,112,18,94,0,30,0,15,0,15,15,444,178,120,58,20,38,0,266,18,16,11,5,232,0,231100
14000US06037231210,140,6,37,1145,199,144,31,113,0,113,0,55,11,44,0,44,0,946,414,129,285,50,235,0,532,70,127,67,60,335,0,231210
14000US06037231220,140,6,37,1161,392,300,117,183,55,128,0,92,19,54,0,54,19,769,417,207,210,9,201,0,352,45,132,21,111,175,0,231220
14000US06037231300,140,6,37,1415,335,268,32,214,8,206,22,67,22,24,0,24,21,1080,379,182,197,25,172,0,701,163,192,47,145,346,0,231300
14000US06037231400,140,6,37,1369,289,180,23,157,25,132,0,109,27,18,10,8,64,1080,437,281,156,19,137,0,643,167,213,6,207,263,0,231400
14000US06037231500,140,6,37,1417,81,47,10,37,0,37,0,34,0,21,0,21,13,1336,520,245,262,74,188,13,816,224,206,99,107,386,0,231500
14000US06037231600,140,6,37,1900,374,259,47,212,27,185,0,115,34,24,16,8,57,1526,708,467,241,83,158,0,818,216,103,26,77,499,0,231600
14000US06037231710,140,6,37,1254,310,288,65,220,26,194,3,22,0,0,0,0,22,944,499,253,234,56,178,12,445,49,99,27,72,297,0,231710
14000US06037231720,140,6,37,1391,211,153,48,105,8,97,0,58,16,14,14,0,28,1180,447,312,135,80,55,0,733,134,130,13,117,469,0,231720
14000US06037231800,140,6,37,1241,404,353,83,270,92,178,0,51,22,0,0,0,29,837,469,198,265,55,210,6,368,133,91,39,52,144,0,231800
14000US06037231900,140,6,37,1325,395,312,145,167,0,167,0,83,0,23,0,23,60,930,487,214,273,59,214,0,443,169,135,89,46,139,0,231900
14000US06037232110,140,6,37,791,193,173,67,106,18,88,0,20,0,8,8,0,12,598,201,123,78,21,57,0,397,88,164,53,111,145,0,232110
14000US06037232120,140,6,37,1232,365,328,103,225,34,191,0,37,0,28,0,28,9,867,429,200,229,97,132,0,438,118,87,47,40,233,0,232120
14000US06037232200,140,6,37,844,92,71,22,49,0,49,0,21,0,21,0,21,0,752,292,116,176,38,138,0,460,91,148,74,74,221,0,232200
14000US06037232300,140,6,37,1019,117,88,17,71,31,40,0,29,0,17,17,0,12,902,333,254,79,13,66,0,569,148,153,36,117,268,0,232300
14000US06037232400,140,6,37,1863,250,191,16,175,0,175,0,59,0,17,0,17,42,1613,592,290,302,139,163,0,1021,257,275,75,200,489,0,232400
14000US06037232500,140,6,37,1460,284,207,78,129,12,117,0,77,10,46,39,7,21,1176,419,125,260,80,180,34,757,144,211,83,128,402,0,232500
14000US06037232600,140,6,37,1753,280,221,96,125,0,125,0,59,0,50,8,42,9,1473,621,294,327,101,226,0,852,245,110,60,50,497,0,232600
14000US06037232700,140,6,37,1555,365,317,120,197,17,180,0,48,0,42,0,42,6,1190,476,287,189,69,120,0,714,184,160,54,106,370,0,232700
14000US06037232800,140,6,37,913,305,275,107,168,17,151,0,30,20,0,0,0,10,608,250,122,128,48,80,0,358,61,150,52,98,147,0,232800
14000US06037234000,140,6,37,2004,336,247,101,146,0,146,0,89,0,0,0,0,89,1668,401,217,154,43,111,30,1267,283,381,153,228,603,0,234000
14000US06037234200,140,6,37,1098,64,12,0,12,0,12,0,52,13,10,0,10,29,1034,203,97,106,10,96,0,831,266,130,11,119,435,0,234200
14000US06037234300,140,6,37,2251,297,104,0,104,45,59,0,193,0,13,0,13,180,1954,343,83,260,12,248,0,1611,201,229,119,110,1181,0,234300
14000US06037234501,140,6,37,867,157,137,35,102,45,57,0,20,0,5,0,5,15,710,192,134,58,12,46,0,518,107,108,11,97,303,0,234501
14000US06037234502,140,6,37,1021,42,20,12,8,0,8,0,22,0,22,9,13,0,979,249,117,132,9,123,0,730,170,168,67,101,392,0,234502
14000US06037234600,140,6,37,1625,239,163,98,65,26,39,0,76,12,0,0,0,64,1386,422,161,261,65,196,0,964,262,198,48,150,504,0,234600
14000US06037234700,140,6,37,1437,141,113,30,83,0,83,0,28,0,0,0,0,28,1296,344,193,151,31,120,0,952,228,147,21,126,577,0,234700
14000US06037234800,140,6,37,1070,115,104,22,82,0,82,0,11,0,0,0,0,11,955,304,221,60,28,32,23,651,169,182,66,116,300,0,234800
14000US06037234901,140,6,37,1163,267,144,55,89,0,89,0,123,0,66,0,66,57,896,281,26,255,138,117,0,615,85,117,54,63,413,0,234901
14000US06037234902,140,6,37,1433,363,240,30,210,13,197,0,123,0,47,0,47,76,1070,340,151,189,0,189,0,730,76,118,34,84,536,0,234902
14000US06037235100,140,6,37,1701,120,91,45,46,0,46,0,29,10,19,0,19,0,1581,474,252,222,66,156,0,1107,210,234,45,189,663,0,235100
14000US06037235201,140,6,37,930,133,74,7,67,0,67,0,59,0,24,7,17,35,797,163,102,61,0,61,0,634,139,138,15,123,357,0,235201
14000US06037235202,140,6,37,1773,267,130,27,103,0,103,0,137,0,21,0,21,116,1506,370,153,176,59,117,41,1136,144,207,68,139,785,0,235202
14000US06037236000,140,6,37,2038,48,24,0,24,0,24,0,24,24,0,0,0,0,1990,411,290,121,36,85,0,1579,386,291,69,222,902,0,236000
14000US06037236100,140,6,37,2652,451,206,20,186,0,186,0,245,74,27,0,27,144,2201,441,134,307,0,307,0,1760,291,240,0,240,1229,0,236100
14000US06037236202,140,6,37,2238,538,274,76,198,0,198,0,264,6,36,0,36,222,1700,468,176,292,69,223,0,1232,93,230,115,115,909,0,236202
14000US06037236203,140,6,37,1495,313,253,74,179,37,142,0,60,0,12,12,0,48,1182,306,152,154,16,138,0,876,136,213,124,89,527,0,236203
14000US06037236204,140,6,37,1192,216,184,15,169,96,73,0,32,0,0,0,0,32,976,388,140,248,106,142,0,588,68,58,33,25,462,0,236204
14000US06037236400,140,6,37,1974,121,47,36,11,0,11,0,74,7,23,0,23,44,1853,450,129,292,26,266,29,1403,328,271,51,220,804,0,236400
14000US06037237101,140,6,37,1007,248,202,105,97,21,76,0,46,32,14,0,14,0,759,410,220,190,36,154,0,349,96,41,9,32,212,0,237101
14000US06037237102,140,6,37,902,213,143,34,109,0,109,0,70,0,48,0,48,22,689,276,108,168,40,128,0,413,84,80,4,76,249,0,237102
14000US06037237201,140,6,37,922,100,95,47,48,17,31,0,5,0,5,0,5,0,822,354,191,163,123,40,0,468,97,147,16,131,224,0,237201
14000US06037237202,140,6,37,1302,170,117,0,117,0,117,0,53,16,26,0,26,11,1132,494,255,239,159,80,0,638,198,174,0,174,266,0,237202
14000US06037237300,140,6,37,1765,273,205,36,169,0,169,0,68,10,10,0,10,48,1492,560,188,372,35,337,0,932,173,209,88,121,550,0,237300
14000US06037237401,140,6,37,989,128,80,46,34,0,34,0,48,0,42,0,42,6,861,414,306,108,7,101,0,447,68,93,0,93,286,0,237401
14000US06037237402,140,6,37,1040,152,128,37,91,25,66,0,24,0,8,0,8,16,888,305,148,157,103,54,0,583,96,136,16,120,351,0,237402
14000US06037237500,140,6,37,782,185,138,47,91,16,75,0,47,2,27,0,27,18,597,261,140,121,66,55,0,336,97,96,42,54,143,0,237500
14000US06037237600,140,6,37,1122,173,128,18,110,20,90,0,45,7,7,0,7,31,949,476,274,202,71,131,0,473,131,52,23,29,290,0,237600
14000US06037237710,140,6,37,980,216,170,22,148,22,126,0,46,0,10,0,10,36,764,310,168,142,45,97,0,454,78,70,9,61,306,0,237710
14000US06037237720,140,6,37,795,238,226,101,125,24,101,0,12,0,0,0,0,12,557,326,128,198,52,146,0,231,29,52,0,52,150,0,237720
14000US06037237800,140,6,37,1185,244,196,56,140,15,125,0,48,0,48,0,48,0,941,353,98,255,26,229,0,588,132,169,69,100,287,0,237800
14000US06037237900,140,6,37,1290,130,68,17,51,26,25,0,62,8,22,0,22,32,1160,409,155,239,106,133,15,751,177,200,88,112,374,0,237900
14000US06037238000,140,6,37,2040,241,141,14,127,10,117,0,100,0,100,51,49,0,1799,600,166,434,103,331,0,1199,302,207,105,102,690,0,238000
14000US06037238100,140,6,37,1723,271,205,0,205,42,163,0,66,0,26,0,26,40,1452,406,283,123,23,100,0,1046,282,231,15,216,533,0,238100
14000US06037238200,140,6,37,2023,313,208,114,94,14,80,0,105,0,24,15,9,81,1710,676,128,548,24,524,0,1034,229,110,17,93,695,0,238200
14000US06037238310,140,6,37,1275,409,355,121,234,18,216,0,54,0,7,0,7,47,866,331,204,127,70,57,0,535,62,101,19,82,372,0,238310
14000US06037238320,140,6,37,954,253,205,61,144,0,144,0,48,0,0,0,0,48,701,284,146,138,47,91,0,417,84,65,18,47,268,0,238320
14000US06037238400,140,6,37,1724,131,64,10,45,0,45,9,67,0,50,0,50,17,1593,328,131,197,35,162,0,1265,378,248,50,198,639,0,238400
14000US06037239201,140,6,37,826,211,152,35,117,64,53,0,59,0,0,0,0,59,615,307,155,152,47,105,0,308,115,114,17,97,79,0,239201
14000US06037239202,140,6,37,1020,255,223,78,145,40,105,0,32,0,0,0,0,32,765,419,215,204,131,73,0,346,150,103,44,59,93,0,239202
14000US06037239310,140,6,37,960,214,176,50,126,26,100,0,38,5,12,4,8,21,746,424,178,246,38,208,0,322,43,143,78,65,136,0,239310
14000US06037239320,140,6,37,857,221,177,44,133,11,122,0,44,10,0,0,0,34,636,288,178,110,50,60,0,348,91,102,6,96,155,0,239320
14000US06037239330,140,6,37,694,153,120,39,81,48,33,0,33,0,22,0,22,11,541,311,203,108,65,43,0,230,59,91,39,52,80,0,239330
14000US06037239501,140,6,37,889,215,193,63,130,16,114,0,22,11,0,0,0,11,674,257,105,136,39,97,16,417,139,160,56,104,118,0,239501
14000US06037239502,140,6,37,821,202,162,93,69,21,48,0,40,7,5,0,5,28,619,307,139,168,32,136,0,312,115,73,45,28,124,0,239502
14000US06037239601,140,6,37,803,277,243,53,190,50,140,0,34,0,0,0,0,34,526,333,193,140,48,92,0,193,123,24,19,5,46,0,239601
14000US06037239602,140,6,37,814,267,253,18,235,55,180,0,14,7,7,0,7,0,547,294,60,234,64,170,0,253,102,42,17,25,109,0,239602
14000US06037239701,140,6,37,1014,450,384,108,276,56,220,0,66,14,23,0,23,29,564,374,173,201,113,88,0,190,51,30,18,12,109,0,239701
14000US06037239702,140,6,37,1014,286,184,24,160,7,153,0,102,0,44,11,33,58,728,307,131,176,52,124,0,421,63,178,71,107,180,0,239702
14000US06037239801,140,6,37,902,276,235,63,172,69,103,0,41,14,22,0,22,5,626,287,134,153,87,66,0,339,110,97,61,36,132,0,239801
14000US06037239802,140,6,37,1144,381,324,136,188,14,174,0,57,0,22,0,22,35,763,352,170,182,94,88,0,411,122,162,114,48,127,0,239802
14000US06037240010,140,6,37,978,292,255,59,196,23,173,0,37,0,15,0,15,22,686,380,240,140,15,125,0,306,73,22,11,11,211,0,240010
14000US06037240020,140,6,37,1263,246,218,84,134,0,134,0,28,0,4,0,4,24,1017,557,348,201,59,142,8,460,148,116,34,82,196,0,240020
14000US06037240200,140,6,37,1289,413,374,51,323,44,279,0,39,0,0,0,0,39,876,398,251,147,27,120,0,478,151,100,77,23,227,0,240200
14000US06037240300,140,6,37,1418,319,184,82,102,0,102,0,135,8,26,0,26,101,1099,428,305,123,39,84,0,671,119,68,0,68,484,0,240300
14000US06037240401,140,6,37,1284,320,223,25,198,20,178,0,97,0,29,8,21,68,964,332,284,48,22,26,0,632,162,99,0,99,371,0,240401
14000US06037240402,140,6,37,1074,149,105,35,70,0,70,0,44,12,0,0,0,32,925,422,187,235,57,178,0,503,138,168,80,88,197,0,240402
14000US06037240500,140,6,37,1421,418,373,77,296,16,280,0,45,0,10,0,10,35,1003,457,251,192,65,127,14,546,110,105,11,94,331,0,240500
14000US06037240600,140,6,37,1206,244,172,13,159,41,118,0,72,21,0,0,0,51,962,321,180,141,80,61,0,641,123,244,118,126,274,0,240600
14000US06037240700,140,6,37,1686,489,381,98,283,39,244,0,108,8,56,8,48,44,1197,394,247,147,31,116,0,803,125,268,127,141,410,0,240700
14000US06037240800,140,6,37,999,392,384,128,247,53,194,9,8,0,8,0,8,0,607,376,248,128,23,105,0,231,96,44,0,44,91,0,240800
14000US06037240900,140,6,37,1256,323,212,63,149,45,104,0,111,7,30,6,24,74,933,541,236,288,87,201,17,392,110,71,9,62,211,0,240900
14000US06037241001,140,6,37,1059,356,256,53,203,35,168,0,100,0,14,7,7,86,703,287,181,106,26,80,0,416,176,97,63,34,143,0,241001
14000US06037241002,140,6,37,934,176,125,61,64,13,51,0,51,0,44,0,44,7,758,321,163,158,36,122,0,437,124,107,32,75,206,0,241002
14000US06037241110,140,6,37,741,110,104,14,90,16,74,0,6,0,6,6,0,0,631,324,154,170,49,121,0,307,68,68,24,44,171,0,241110
14000US06037241120,140,6,37,1073,291,242,71,171,32,139,0,49,0,13,6,7,36,782,438,227,195,21,174,16,344,54,145,35,110,145,0,241120
14000US06037241201,140,6,37,817,151,112,24,88,0,88,0,39,9,14,0,14,16,666,278,146,132,15,117,0,388,94,46,13,33,248,0,241201
14000US06037241202,140,6,37,1440,314,208,105,103,18,85,0,106,11,8,0,8,87,1126,450,123,327,76,251,0,676,174,134,69,65,368,0,241202
14000US06037241300,140,6,37,687,177,139,28,111,18,93,0,38,12,5,0,5,21,510,157,56,96,51,45,5,353,159,37,12,25,157,0,241300
14000US06037241400,140,6,37,869,176,120,31,89,22,67,0,56,0,56,16,40,0,693,391,259,132,71,61,0,302,62,122,35,87,118,0,241400
14000US06037242000,140,6,37,964,175,152,37,111,26,85,4,23,0,23,0,23,0,789,371,247,124,17,107,0,418,117,98,21,77,203,0,242000
14000US06037242100,140,6,37,700,402,378,102,276,5,271,0,24,0,16,7,9,8,298,95,28,67,0,67,0,203,26,51,25,26,126,0,242100
14000US06037242200,140,6,37,1449,320,240,64,176,21,155,0,80,0,66,26,40,14,1129,509,269,240,123,117,0,620,162,105,56,49,353,0,242200
14000US06037242300,140,6,37,1069,362,299,135,164,68,96,0,63,0,27,0,27,36,707,538,357,181,81,100,0,169,35,67,7,60,67,0,242300
14000US06037242600,140,6,37,1212,618,557,113,444,70,374,0,61,0,42,0,42,19,594,316,103,213,9,204,0,278,37,97,32,65,144,0,242600
14000US06037242700,140,6,37,1135,346,336,112,224,30,194,0,10,0,10,0,10,0,789,381,232,149,73,76,0,408,69,100,35,65,239,0,242700
14000US06037243000,140,6,37,1140,339,289,58,231,42,189,0,50,30,20,20,0,0,801,462,275,187,45,142,0,339,138,78,22,56,123,0,243000
14000US06037243100,140,6,37,1282,572,461,121,340,66,274,0,111,36,61,36,25,14,710,395,237,158,37,121,0,315,64,87,6,81,164,0,243100
14000US06037261101,140,6,37,1476,0,0,0,0,0,0,0,0,0,0,0,0,0,1476,461,358,103,70,33,0,1015,488,112,34,78,415,0,261101
14000US06037261102,140,6,37,1681,0,0,0,0,0,0,0,0,0,0,0,0,0,1681,580,442,138,44,94,0,1101,576,41,22,19,484,0,261102
14000US06037261200,140,6,37,1668,0,0,0,0,0,0,0,0,0,0,0,0,0,1668,433,365,68,19,49,0,1235,546,130,67,63,559,0,261200
14000US06037262100,140,6,37,1221,0,0,0,0,0,0,0,0,0,0,0,0,0,1221,287,229,45,34,11,13,934,588,91,28,63,255,0,262100
14000US06037262200,140,6,37,1769,0,0,0,0,0,0,0,0,0,0,0,0,0,1769,539,449,90,40,50,0,1230,719,32,11,21,479,0,262200
14000US06037262301,140,6,37,922,0,0,0,0,0,0,0,0,0,0,0,0,0,922,240,177,63,44,19,0,682,430,12,12,0,240,0,262301
14000US06037262302,140,6,37,1201,0,0,0,0,0,0,0,0,0,0,0,0,0,1201,351,286,65,0,65,0,850,343,81,25,56,426,0,262302
14000US06037262303,140,6,37,1141,0,0,0,0,0,0,0,0,0,0,0,0,0,1141,342,311,31,16,15,0,799,574,17,0,17,208,0,262303
14000US06037262400,140,6,37,1246,0,0,0,0,0,0,0,0,0,0,0,0,0,1246,378,293,68,39,29,17,868,589,35,35,0,244,0,262400
14000US06037262501,140,6,37,1350,0,0,0,0,0,0,0,0,0,0,0,0,0,1350,522,429,93,42,51,0,828,445,48,0,48,335,0,262501
14000US06037262601,140,6,37,1403,0,0,0,0,0,0,0,0,0,0,0,0,0,1403,584,547,37,9,28,0,819,515,66,0,66,238,0,262601
14000US06037262604,140,6,37,2517,16,16,0,16,0,16,0,0,0,0,0,0,0,2501,737,618,119,39,80,0,1764,956,148,69,79,660,0,262604
14000US06037262704,140,6,37,1472,0,0,0,0,0,0,0,0,0,0,0,0,0,1472,457,372,85,7,78,0,1015,361,53,27,26,601,0,262704
14000US06037262706,140,6,37,1302,7,0,0,0,0,0,0,7,0,0,0,0,7,1295,483,425,58,10,48,0,812,445,16,5,11,351,0,262706
14000US06037262802,140,6,37,1532,0,0,0,0,0,0,0,0,0,0,0,0,0,1532,293,268,25,25,0,0,1239,609,94,18,76,536,0,262802
14000US06037264000,140,6,37,1259,0,0,0,0,0,0,0,0,0,0,0,0,0,1259,364,364,0,0,0,0,895,423,12,0,12,460,0,264000
14000US06037264102,140,6,37,1654,0,0,0,0,0,0,0,0,0,0,0,0,0,1654,270,188,76,0,76,6,1384,175,58,26,32,1151,0,264102
14000US06037264103,140,6,37,1427,19,19,0,19,0,19,0,0,0,0,0,0,0,1408,139,118,21,0,21,0,1269,212,11,0,11,1046,0,264103
14000US06037264301,140,6,37,2869,0,0,0,0,0,0,0,0,0,0,0,0,0,2869,252,240,12,0,12,0,2617,373,191,88,103,2053,0,264301
14000US06037264302,140,6,37,2906,0,0,0,0,0,0,0,0,0,0,0,0,0,2906,297,283,14,0,14,0,2609,509,172,26,146,1928,0,264302
14000US06037265100,140,6,37,1378,0,0,0,0,0,0,0,0,0,0,0,0,0,1378,228,167,61,30,31,0,1150,302,45,0,45,803,0,265100
14000US06037265201,140,6,37,938,0,0,0,0,0,0,0,0,0,0,0,0,0,938,177,151,26,8,18,0,761,224,104,52,52,433,0,265201
14000US06037265202,140,6,37,1955,25,0,0,0,0,0,0,25,0,0,0,0,25,1930,188,133,55,0,55,0,1742,513,74,20,54,1155,0,265202
14000US06037265301,140,6,37,0,0,0,0,0,0,0,0,0,0,0,0,0,0,0,0,0,0,0,0,0,0,0,0,0,0,0,0,265301
14000US06037265303,140,6,37,1514,15,0,0,0,0,0,0,15,0,0,0,0,15,1499,35,32,3,3,0,0,1464,61,20,13,7,1383,0,265303
14000US06037265304,140,6,37,975,0,0,0,0,0,0,0,0,0,0,0,0,0,975,10,10,0,0,0,0,965,31,20,20,0,914,0,265304
14000US06037265305,140,6,37,1872,0,0,0,0,0,0,0,0,0,0,0,0,0,1872,68,52,16,16,0,0,1804,108,31,10,21,1665,0,265305
14000US06037265410,140,6,37,617,6,6,0,6,0,6,0,0,0,0,0,0,0,611,188,137,51,13,38,0,423,90,33,4,29,300,0,265410
14000US06037265420,140,6,37,771,6,0,0,0,0,0,0,6,6,0,0,0,0,765,182,178,4,0,4,0,583,199,30,25,5,354,0,265420
14000US06037265510,140,6,37,2279,0,0,0,0,0,0,0,0,0,0,0,0,0,2279,67,35,32,32,0,0,2212,241,63,36,27,1908,0,265510
14000US06037265520,140,6,37,2224,0,0,0,0,0,0,0,0,0,0,0,0,0,2224,248,123,125,54,71,0,1976,555,96,49,47,1325,0,265520
14000US06037265601,140,6,37,1409,0,0,0,0,0,0,0,0,0,0,0,0,0,1409,243,191,52,0,52,0,1166,305,72,16,56,789,0,265601
14000US06037265602,140,6,37,1602,0,0,0,0,0,0,0,0,0,0,0,0,0,1602,160,139,21,0,21,0,1442,510,111,48,63,821,0,265602
14000US06037265700,140,6,37,2438,0,0,0,0,0,0,0,0,0,0,0,0,0,2438,394,317,77,27,50,0,2044,601,202,73,129,1241,0,265700
14000US06037267100,140,6,37,2794,44,23,0,23,0,23,0,21,0,13,0,13,8,2750,499,436,63,13,50,0,2251,625,194,45,149,1432,0,267100
14000US06037267200,140,6,37,2674,28,0,0,0,0,0,0,28,0,0,0,0,28,2646,383,317,66,27,39,0,2263,527,192,35,157,1544,0,267200
14000US06037267300,140,6,37,2101,42,42,0,42,0,42,0,0,0,0,0,0,0,2059,262,220,42,0,42,0,1797,277,219,144,75,1301,0,267300
14000US06037267402,140,6,37,2386,10,0,0,0,0,0,0,10,0,0,0,0,10,2376,154,114,40,14,26,0,2222,520,121,48,73,1581,0,267402
14000US06037267403,140,6,37,1703,33,0,0,0,0,0,0,33,0,0,0,0,33,1670,152,97,55,36,19,0,1518,195,60,5,55,1263,0,267403
14000US06037267404,140,6,37,1537,12,12,0,12,0,12,0,0,0,0,0,0,0,1525,152,152,0,0,0,0,1373,172,102,73,29,1099,0,267404
14000US06037267501,140,6,37,2536,16,16,16,0,0,0,0,0,0,0,0,0,0,2520,533,292,241,193,48,0,1987,341,135,87,48,1511,0,267501
14000US06037267502,140,6,37,1599,18,0,0,0,0,0,0,18,18,0,0,0,0,1581,214,164,50,0,50,0,1367,164,103,74,29,1100,0,267502
14000US06037267600,140,6,37,1218,64,39,11,28,28,0,0,25,8,0,0,0,17,1154,249,136,113,0,113,0,905,254,153,60,93,498,0,267600
14000US06037267700,140,6,37,1634,19,0,0,0,0,0,0,19,0,0,0,0,19,1615,188,151,37,15,22,0,1427,421,198,108,90,808,0,267700
14000US06037267800,140,6,37,1122,8,0,0,0,0,0,0,8,8,0,0,0,0,1114,397,377,20,7,13,0,717,306,38,0,38,373,0,267800
14000US06037267901,140,6,37,1465,0,0,0,0,0,0,0,0,0,0,0,0,0,1465,126,76,50,0,50,0,1339,464,42,8,34,833,0,267901
14000US06037267902,140,6,37,1658,0,0,0,0,0,0,0,0,0,0,0,0,0,1658,373,341,13,0,13,19,1285,350,79,16,63,856,0,267902
14000US06037269000,140,6,37,2262,13,0,0,0,0,0,0,13,13,0,0,0,0,2249,620,536,84,66,18,0,1629,615,166,0,166,848,0,269000
14000US06037269100,140,6,37,1963,104,0,0,0,0,0,0,104,76,0,0,0,28,1859,496,409,70,22,48,17,1363,397,61,0,61,905,0,269100
14000US06037269300,140,6,37,1546,0,0,0,0,0,0,0,0,0,0,0,0,0,1546,580,434,146,0,146,0,966,406,111,34,77,449,0,269300
14000US06037269500,140,6,37,1386,0,0,0,0,0,0,0,0,0,0,0,0,0,1386,503,455,48,15,33,0,883,506,51,7,44,326,0,269500
14000US06037269601,140,6,37,1057,138,91,11,80,0,80,0,47,34,0,0,0,13,919,258,119,121,61,60,18,661,182,100,9,91,379,0,269601
14000US06037269602,140,6,37,1121,111,111,59,52,0,52,0,0,0,0,0,0,0,1010,229,144,85,15,70,0,781,178,96,0,96,507,0,269602
14000US06037269700,140,6,37,1630,29,15,0,15,0,15,0,14,0,5,5,0,9,1601,365,279,86,20,66,0,1236,353,56,32,24,827,0,269700
14000US06037269800,140,6,37,1602,4,0,0,0,0,0,0,4,0,4,4,0,0,1598,451,285,166,22,144,0,1147,204,57,10,47,886,0,269800
14000US06037269903,140,6,37,1797,57,17,17,0,0,0,0,40,0,0,0,0,40,1740,331,292,39,15,24,0,1409,130,212,42,170,1067,0,269903
14000US06037269904,140,6,37,1981,63,52,20,32,0,32,0,11,0,0,0,0,11,1918,317,165,152,75,77,0,1601,257,79,0,79,1265,0,269904
14000US06037269905,140,6,37,1254,93,75,31,44,0,44,0,18,18,0,0,0,0,1161,283,123,160,129,31,0,878,79,110,0,110,689,0,269905
14000US06037269906,140,6,37,1495,19,11,11,0,0,0,0,8,0,0,0,0,8,1476,219,207,12,0,12,0,1257,200,90,7,83,967,0,269906
14000US06037269907,140,6,37,1346,118,90,49,41,0,41,0,28,0,12,0,12,16,1228,105,62,43,8,35,0,1123,209,111,0,111,803,0,269907
14000US06037270100,140,6,37,2415,89,47,13,24,24,0,10,42,0,9,9,0,33,2326,236,187,49,32,17,0,2090,438,169,85,84,1483,0,270100
14000US06037270200,140,6,37,1211,0,0,0,0,0,0,0,0,0,0,0,0,0,1211,429,273,156,38,118,0,782,277,69,31,38,436,0,270200
14000US06037270300,140,6,37,958,43,31,18,13,0,13,0,12,0,12,12,0,0,915,193,145,48,18,30,0,722,188,122,82,40,412,0,270300
14000US06037271100,140,6,37,958,0,0,0,0,0,0,0,0,0,0,0,0,0,958,282,201,81,0,81,0,676,243,51,26,25,382,0,271100
14000US06037271200,140,6,37,1149,14,14,9,5,0,5,0,0,0,0,0,0,0,1135,276,168,108,8,100,0,859,95,95,33,62,669,0,271200
14000US06037271300,140,6,37,1942,52,32,0,32,0,32,0,20,0,0,0,0,20,1890,331,274,33,0,33,24,1559,511,211,41,170,837,0,271300
14000US06037271400,140,6,37,1356,27,0,0,0,0,0,0,27,0,27,27,0,0,1329,427,412,15,0,15,0,902,419,109,39,70,374,0,271400
14000US06037271500,140,6,37,1322,7,0,0,0,0,0,0,7,0,7,7,0,0,1315,343,276,67,10,57,0,972,375,82,26,56,515,0,271500
14000US06037271600,140,6,37,1955,53,42,8,34,0,34,0,11,0,0,0,0,11,1902,565,477,88,0,88,0,1337,633,69,21,48,635,0,271600
14000US06037271701,140,6,37,2709,12,0,0,0,0,0,0,12,0,0,0,0,12,2697,551,456,95,44,51,0,2146,422,187,46,141,1537,0,271701
14000US06037271702,140,6,37,1823,65,30,30,0,0,0,0,35,0,18,0,18,17,1758,553,396,157,24,133,0,1205,522,59,21,38,624,0,271702
14000US06037271801,140,6,37,1721,31,9,0,9,0,9,0,22,0,14,14,0,8,1690,290,177,113,72,41,0,1400,310,198,88,110,892,0,271801
14000US06037271802,140,6,37,2754,88,13,0,13,0,13,0,75,41,0,0,0,34,2666,442,333,109,16,93,0,2224,498,203,37,166,1523,0,271802
14000US06037271901,140,6,37,1278,0,0,0,0,0,0,0,0,0,0,0,0,0,1278,335,238,97,28,69,0,943,327,161,98,63,455,0,271901
14000US06037271902,140,6,37,1779,73,19,19,0,0,0,0,54,31,0,0,0,23,1706,397,366,31,31,0,0,1309,302,116,21,95,891,0,271902
14000US06037272100,140,6,37,1743,33,10,0,0,0,0,10,23,5,0,0,0,18,1710,606,474,132,36,96,0,1104,331,73,40,33,700,0,272100
14000US06037272201,140,6,37,1141,8,8,0,8,8,0,0,0,0,0,0,0,0,1133,212,116,96,38,58,0,921,160,77,0,77,684,0,272201
14000US06037272202,140,6,37,1543,86,78,52,26,0,26,0,8,0,0,0,0,8,1457,217,173,44,29,15,0,1240,185,182,107,75,873,0,272202
14000US06037272301,140,6,37,1323,36,27,0,27,0,27,0,9,0,0,0,0,9,1287,225,121,104,55,49,0,1062,224,199,81,118,639,0,272301
14000US06037272302,140,6,37,1977,42,18,18,0,0,0,0,24,0,24,24,0,0,1935,380,251,129,45,84,0,1555,178,186,101,85,1191,0,272302
14000US06037273100,140,6,37,898,0,0,0,0,0,0,0,0,0,0,0,0,0,898,181,131,50,24,26,0,717,224,51,33,18,442,0,273100
14000US06037273200,140,6,37,1559,107,53,0,53,0,53,0,54,0,10,0,10,44,1452,260,181,79,27,52,0,1192,243,87,21,66,862,0,273200
14000US06037273300,140,6,37,1604,111,89,10,79,27,52,0,22,0,0,0,0,22,1493,359,216,104,23,81,39,1134,265,29,11,18,840,0,273300
14000US06037273402,140,6,37,1987,15,0,0,0,0,0,0,15,0,0,0,0,15,1972,68,68,0,0,0,0,1904,156,29,17,12,1719,0,273402
14000US06037273502,140,6,37,1834,18,18,0,18,0,18,0,0,0,0,0,0,0,1816,88,44,44,36,8,0,1728,203,38,0,38,1487,0,273502
14000US06037273600,140,6,37,1140,11,11,11,0,0,0,0,0,0,0,0,0,0,1129,256,158,98,41,57,0,873,212,17,17,0,644,0,273600
14000US06037273700,140,6,37,1241,26,0,0,0,0,0,0,26,0,0,0,0,26,1215,328,221,94,35,59,13,887,225,88,39,49,574,0,273700
14000US06037273800,140,6,37,1608,0,0,0,0,0,0,0,0,0,0,0,0,0,1608,301,214,87,23,64,0,1307,206,82,20,62,1019,0,273800
14000US06037273902,140,6,37,2167,11,11,11,0,0,0,0,0,0,0,0,0,0,2156,258,129,129,80,49,0,1898,319,137,63,74,1442,0,273902
14000US06037274100,140,6,37,2276,0,0,0,0,0,0,0,0,0,0,0,0,0,2276,380,351,29,29,0,0,1896,346,81,36,45,1469,0,274100
14000US06037274202,140,6,37,2173,59,0,0,0,0,0,0,59,0,0,0,0,59,2114,245,207,38,22,16,0,1869,502,52,10,42,1315,0,274202
14000US06037275101,140,6,37,503,29,18,18,0,0,0,0,11,4,0,0,0,7,474,115,105,10,0,10,0,359,106,42,22,20,211,0,275101
14000US06037275102,140,6,37,1296,61,61,61,0,0,0,0,0,0,0,0,0,0,1235,423,354,69,45,24,0,812,265,109,37,72,438,0,275102
14000US06037275200,140,6,37,1603,37,30,14,16,0,16,0,7,0,0,0,0,7,1566,551,376,175,87,88,0,1015,177,133,94,39,705,0,275200
14000US06037275302,140,6,37,2544,0,0,0,0,0,0,0,0,0,0,0,0,0,2544,355,208,147,78,69,0,2189,661,143,71,72,1385,0,275302
14000US06037275311,140,6,37,2284,254,76,0,76,0,76,0,178,0,141,42,99,37,2030,446,277,169,54,115,0,1584,567,92,55,37,925,0,275311
14000US06037275400,140,6,37,1661,29,8,0,8,0,8,0,21,0,0,0,0,21,1632,310,189,121,12,109,0,1322,311,83,10,73,928,0,275400
14000US06037275500,140,6,37,1634,275,227,81,146,26,120,0,48,4,10,0,10,34,1359,440,277,163,8,155,0,919,321,241,126,115,357,0,275500
14000US06037275602,140,6,37,3662,0,0,0,0,0,0,0,0,0,0,0,0,0,3662,657,480,162,29,133,15,3005,559,217,124,93,2229,0,275602
14000US06037275603,140,6,37,1186,59,47,13,34,0,34,0,12,0,0,0,0,12,1127,297,129,168,10,158,0,830,284,71,44,27,475,0,275603
14000US06037276000,140,6,37,2221,12,12,0,12,0,12,0,0,0,0,0,0,0,2209,586,488,98,28,70,0,1623,799,104,57,47,720,0,276000
14000US06037276100,140,6,37,2866,119,83,8,75,16,59,0,36,0,20,20,0,16,2747,511,274,237,14,223,0,2236,395,237,98,139,1604,0,276100
14000US06037276400,140,6,37,1565,14,0,0,0,0,0,0,14,8,6,6,0,0,1551,429,388,41,7,34,0,1122,541,195,97,98,386,0,276400
14000US06037276500,140,6,37,717,9,0,0,0,0,0,0,9,0,0,0,0,9,708,163,144,19,0,19,0,545,170,70,43,27,305,0,276500
14000US06037276601,140,6,37,1627,37,29,0,29,0,29,0,8,0,0,0,0,8,1590,349,256,93,19,74,0,1241,548,72,24,48,621,0,276601
14000US06037276603,140,6,37,3212,0,0,0,0,0,0,0,0,0,0,0,0,0,3212,218,212,6,0,6,0,2994,542,210,121,89,2242,0,276603
14000US06037276604,140,6,37,2409,0,0,0,0,0,0,0,0,0,0,0,0,0,2409,91,91,0,0,0,0,2318,616,115,28,87,1587,0,276604
14000US06037277000,140,6,37,2110,13,0,0,0,0,0,0,13,13,0,0,0,0,2097,620,536,84,0,84,0,1477,764,85,71,14,628,0,277000
14000US06037277100,140,6,37,1094,16,6,6,0,0,0,0,10,0,0,0,0,10,1078,336,284,52,0,52,0,742,383,69,24,45,290,0,277100
14000US06037277200,140,6,37,1011,43,31,20,11,0,11,0,12,0,3,0,3,9,968,294,226,68,0,68,0,674,73,154,58,96,447,0,277200
14000US06037277400,140,6,37,624,104,59,19,40,0,40,0,45,10,20,0,20,15,520,137,60,77,49,28,0,383,67,103,37,66,213,0,277400
14000US06037278001,140,6,37,922,35,30,8,22,0,22,0,5,0,5,0,5,0,887,281,244,37,3,34,0,606,222,27,0,27,357,0,278001
14000US06037278102,140,6,37,1499,37,19,19,0,0,0,0,18,0,0,0,0,18,1462,196,153,43,17,26,0,1266,402,42,20,22,822,0,278102
14000US06037291110,140,6,37,1135,198,160,45,115,0,115,0,38,0,38,8,30,0,937,321,121,200,36,164,0,616,137,168,46,122,311,0,291110
14000US06037291120,140,6,37,630,172,134,35,99,14,85,0,38,10,20,0,20,8,458,216,158,58,8,50,0,242,85,24,6,18,133,0,291120
14000US06037291130,140,6,37,995,97,78,0,78,13,65,0,19,0,4,0,4,15,898,382,335,47,16,31,0,516,225,167,42,125,124,0,291130
14000US06037291210,140,6,37,1449,146,139,0,139,23,116,0,7,0,7,0,7,0,1303,550,299,251,54,197,0,753,267,181,119,62,305,0,291210
14000US06037291220,140,6,37,1029,131,107,25,82,0,82,0,24,17,7,0,7,0,898,299,267,32,5,27,0,599,249,43,21,22,307,0,291220
14000US06037291300,140,6,37,957,5,0,0,0,0,0,0,5,0,0,0,0,5,952,199,103,96,57,39,0,753,325,115,40,75,313,0,291300
14000US06037292000,140,6,37,1882,256,188,54,100,8,92,34,68,22,31,8,23,15,1626,669,394,275,46,229,0,957,312,305,116,189,340,0,292000
14000US06037293201,140,6,37,2045,201,198,100,98,0,98,0,3,3,0,0,0,0,1844,687,598,89,0,89,0,1157,345,158,95,63,654,0,293201
14000US06037293202,140,6,37,1766,356,340,109,231,109,122,0,16,0,7,7,0,9,1410,528,333,195,76,119,0,882,212,244,128,116,426,0,293202
14000US06037293301,140,6,37,1048,16,0,0,0,0,0,0,16,0,0,0,0,16,1032,295,227,68,0,68,0,737,363,166,96,70,208,0,293301
14000US06037293302,140,6,37,1596,41,26,0,26,0,26,0,15,8,0,0,0,7,1555,625,408,198,122,76,19,930,387,233,115,118,310,0,293302
14000US06037293304,140,6,37,1444,188,168,70,98,29,69,0,20,11,0,0,0,9,1256,397,255,142,34,108,0,859,235,226,89,137,398,0,293304
14000US06037293306,140,6,37,801,67,44,4,40,11,29,0,23,0,10,0,10,13,734,274,220,54,6,48,0,460,186,51,19,32,223,0,293306
14000US06037293307,140,6,37,843,83,27,0,27,0,27,0,56,16,6,0,6,34,760,369,203,158,5,153,8,391,99,118,41,77,174,0,293307
14000US06037294110,140,6,37,1063,114,114,39,75,0,75,0,0,0,0,0,0,0,949,516,325,160,53,107,31,433,173,113,57,56,147,0,294110
14000US06037294120,140,6,37,528,120,92,61,31,0,31,0,28,14,14,0,14,0,408,233,187,46,12,34,0,175,68,58,10,48,49,0,294120
14000US06037294200,140,6,37,1326,72,72,39,33,33,0,0,0,0,0,0,0,0,1254,653,427,217,86,131,9,601,303,88,31,57,210,0,294200
14000US06037294301,140,6,37,675,61,54,48,6,0,6,0,7,0,7,0,7,0,614,229,168,61,25,36,0,385,189,84,26,58,112,0,294301
14000US06037294302,140,6,37,1228,137,101,54,47,0,47,0,36,12,24,24,0,0,1091,621,341,280,148,132,0,470,144,67,22,45,259,0,294302
14000US06037294410,140,6,37,1598,196,151,70,81,0,81,0,45,9,20,0,20,16,1402,600,387,190,21,169,23,802,229,169,17,152,404,0,294410
14000US06037294421,140,6,37,898,119,88,24,64,12,52,0,31,12,0,0,0,19,779,233,115,114,9,105,4,546,180,70,38,32,296,0,294421
14000US06037294510,140,6,37,949,155,155,90,65,10,55,0,0,0,0,0,0,0,794,413,261,152,47,105,0,381,105,174,89,85,102,0,294510
14000US06037294520,140,6,37,940,185,149,63,86,0,86,0,36,20,16,9,7,0,755,340,194,146,67,79,0,415,126,137,40,97,152,0,294520
14000US06037294610,140,6,37,1153,157,148,90,58,19,39,0,9,0,9,0,9,0,996,436,244,192,73,119,0,560,166,94,54,40,300,0,294610
14000US06037294620,140,6,37,1057,168,159,72,87,14,73,0,9,9,0,0,0,0,889,403,279,124,74,50,0,486,260,124,29,95,102,0,294620
14000US06037294701,140,6,37,798,199,109,67,42,19,23,0,90,10,69,0,69,11,599,321,125,196,124,72,0,278,82,30,30,0,166,0,294701
14000US06037294810,140,6,37,986,276,230,73,157,64,93,0,46,18,12,0,12,16,710,365,204,161,59,102,0,345,130,117,39,78,98,0,294810
14000US06037294820,140,6,37,876,233,213,124,89,18,71,0,20,0,20,0,20,0,643,355,189,166,30,136,0,288,52,96,32,64,140,0,294820
14000US06037294830,140,6,37,954,206,162,75,87,13,74,0,44,4,0,0,0,40,748,396,232,164,40,124,0,352,91,53,34,19,208,0,294830
14000US06037294900,140,6,37,750,182,147,29,118,0,118,0,35,0,29,19,10,6,568,283,116,157,35,122,10,285,135,61,24,37,89,0,294900
14000US06037295103,140,6,37,2065,25,17,0,17,0,17,0,8,8,0,0,0,0,2040,536,323,213,29,184,0,1504,706,136,36,100,662,0,295103
14000US06037296210,140,6,37,937,198,165,51,114,29,85,0,33,6,27,13,14,0,739,254,106,148,0,148,0,485,119,117,19,98,249,0,296210
14000US06037296220,140,6,37,1541,378,299,146,153,10,143,0,79,0,30,0,30,49,1163,274,117,157,0,157,0,889,113,110,65,45,666,0,296220
14000US06037296300,140,6,37,1783,39,18,18,0,0,0,0,21,9,12,0,12,0,1744,329,185,133,44,89,11,1415,466,148,18,130,801,0,296300
14000US06037296401,140,6,37,1268,14,0,0,0,0,0,0,14,8,0,0,0,6,1254,307,221,86,46,40,0,947,443,118,52,66,386,0,296401
14000US06037296402,140,6,37,1118,62,51,34,17,17,0,0,11,0,11,0,11,0,1056,336,198,127,62,65,11,720,311,76,18,58,333,0,296402
14000US06037296500,140,6,37,1273,186,180,68,112,33,79,0,6,0,0,0,0,6,1087,345,233,112,33,79,0,742,327,147,35,112,268,0,296500
14000US06037296600,140,6,37,1916,335,290,78,212,0,212,0,45,4,33,33,0,8,1581,508,259,249,105,144,0,1073,251,240,72,168,582,0,296600
14000US06037296901,140,6,37,1484,259,201,75,126,0,126,0,58,0,32,9,23,26,1225,424,229,195,73,122,0,801,112,150,48,102,539,0,296901
14000US06037296902,140,6,37,1578,34,26,0,26,0,26,0,8,0,0,0,0,8,1544,471,200,271,83,188,0,1073,266,268,239,29,539,0,296902
14000US06037297000,140,6,37,2117,15,0,0,0,0,0,0,15,0,0,0,0,15,2102,490,334,156,13,143,0,1612,657,79,14,65,876,0,297000
14000US06037297110,140,6,37,1501,274,190,48,142,7,135,0,84,0,43,0,43,41,1227,497,243,254,19,235,0,730,137,73,17,56,520,0,297110
14000US06037297120,140,6,37,1162,161,123,83,40,15,25,0,38,12,26,0,26,0,1001,409,261,148,66,82,0,592,97,87,20,67,408,0,297120
14000US06037297201,140,6,37,1275,163,109,18,91,0,91,0,54,30,9,0,9,15,1112,301,157,117,9,108,27,811,197,86,40,46,528,0,297201
14000US06037297202,140,6,37,1444,128,49,49,0,0,0,0,79,0,39,0,39,40,1316,463,281,182,19,163,0,853,247,194,0,194,412,0,297202
14000US06037297300,140,6,37,794,11,6,6,0,0,0,0,5,0,0,0,0,5,783,301,224,71,8,63,6,482,213,89,41,48,180,0,297300
14000US06037297400,140,6,37,1572,8,0,0,0,0,0,0,8,0,0,0,0,8,1564,297,257,40,0,40,0,1267,646,89,56,33,532,0,297400
14000US06037297500,140,6,37,2067,85,47,0,47,47,0,0,38,0,38,0,38,0,1982,475,350,125,39,86,0,1507,456,269,51,218,782,0,297500
14000US06037297601,140,6,37,1235,82,0,0,0,0,0,0,82,0,0,0,0,82,1153,350,187,163,28,135,0,803,243,38,21,17,522,0,297601
14000US06037297602,140,6,37,1738,29,0,0,0,0,0,0,29,0,7,7,0,22,1709,467,188,279,41,238,0,1242,318,128,80,48,796,0,297602
14000US06037300100,140,6,37,1995,11,0,0,0,0,0,0,11,0,11,11,0,0,1984,740,657,83,16,67,0,1244,806,38,9,29,400,0,300100
14000US06037300200,140,6,37,1943,32,0,0,0,0,0,0,32,10,22,0,22,0,1911,810,677,133,55,78,0,1101,617,69,14,55,415,0,300200
14000US06037300301,140,6,37,2138,15,0,0,0,0,0,0,15,0,15,0,15,0,2123,950,797,153,18,135,0,1173,744,147,71,76,282,0,300301
14000US06037300400,140,6,37,1936,36,30,11,19,0,19,0,6,6,0,0,0,0,1900,713,580,133,0,133,0,1187,581,158,65,93,448,0,300400
14000US06037300501,140,6,37,1024,58,58,6,52,19,33,0,0,0,0,0,0,0,966,381,286,95,0,95,0,585,257,95,27,68,233,0,300501
14000US06037300502,140,6,37,2521,70,70,29,41,0,41,0,0,0,0,0,0,0,2451,789,509,243,71,172,37,1662,535,113,0,113,1014,0,300502
14000US06037300600,140,6,37,3333,64,12,12,0,0,0,0,52,13,0,0,0,39,3269,1186,1036,150,39,111,0,2083,730,289,103,186,1064,0,300600
14000US06037300701,140,6,37,2125,0,0,0,0,0,0,0,0,0,0,0,0,0,2125,675,541,134,69,65,0,1450,819,221,102,119,410,0,300701
14000US06037300702,140,6,37,1951,0,0,0,0,0,0,0,0,0,0,0,0,0,1951,594,478,116,67,49,0,1357,848,140,50,90,369,0,300702
14000US06037300800,140,6,37,2649,50,14,0,14,0,14,0,36,0,19,0,19,17,2599,914,661,253,0,253,0,1685,645,289,120,169,751,0,300800
14000US06037300901,140,6,37,2173,19,0,0,0,0,0,0,19,19,0,0,0,0,2154,706,663,43,15,28,0,1448,803,216,133,83,429,0,300901
14000US06037300902,140,6,37,712,3,0,0,0,0,0,0,3,3,0,0,0,0,709,211,156,55,6,49,0,498,298,48,40,8,152,0,300902
14000US06037301000,140,6,37,1900,35,35,35,0,0,0,0,0,0,0,0,0,0,1865,516,319,197,31,166,0,1349,390,276,76,200,683,0,301000
14000US06037301100,140,6,37,2615,42,42,42,0,0,0,0,0,0,0,0,0,0,2573,634,559,75,27,48,0,1939,744,302,15,287,893,0,301100
14000US06037301203,140,6,37,1863,82,21,11,10,0,10,0,61,39,13,0,13,9,1781,359,274,85,17,68,0,1422,641,172,17,155,609,0,301203
14000US06037301204,140,6,37,1961,83,38,38,0,0,0,0,45,23,22,12,10,0,1878,442,349,93,42,51,0,1436,428,247,55,192,761,0,301204
14000US06037301205,140,6,37,713,0,0,0,0,0,0,0,0,0,0,0,0,0,713,196,189,7,4,3,0,517,324,71,14,57,122,0,301205
14000US06037301206,140,6,37,1848,144,127,92,35,0,35,0,17,0,0,0,0,17,1704,396,364,5,0,5,27,1308,639,199,69,130,470,0,301206
14000US06037301300,140,6,37,715,6,0,0,0,0,0,0,6,6,0,0,0,0,709,227,196,18,0,18,13,482,241,31,17,14,210,0,301300
14000US06037301400,140,6,37,1303,22,0,0,0,0,0,0,22,16,0,0,0,6,1281,429,376,53,18,35,0,852,650,67,9,58,135,0,301400
14000US06037301501,140,6,37,604,0,0,0,0,0,0,0,0,0,0,0,0,0,604,133,123,10,0,10,0,471,239,47,17,30,185,0,301501
14000US06037301502,140,6,37,2510,500,406,320,86,0,86,0,94,49,45,32,13,0,2010,422,362,60,39,21,0,1588,712,217,75,142,659,0,301502
14000US06037301601,140,6,37,2335,181,112,70,42,42,0,0,69,0,25,25,0,44,2154,608,371,237,20,217,0,1546,726,211,30,181,609,0,301601
14000US06037301602,140,6,37,1561,103,68,28,40,13,27,0,35,0,0,0,0,35,1458,375,256,119,26,93,0,1083,284,180,85,95,619,0,301602
14000US06037301701,140,6,37,1075,56,0,0,0,0,0,0,56,9,47,47,0,0,1019,202,189,13,0,13,0,817,332,92,11,81,393,0,301701
14000US06037301702,140,6,37,1869,169,125,67,58,0,58,0,44,19,25,0,25,0,1700,397,278,119,40,79,0,1303,538,245,116,129,520,0,301702
14000US06037301801,140,6,37,1656,79,62,42,20,0,20,0,17,0,0,0,0,17,1577,515,336,179,86,93,0,1062,299,134,61,73,629,0,301801
14000US06037301802,140,6,37,1268,204,135,135,0,0,0,0,69,10,12,0,12,47,1064,346,232,114,26,88,0,718,295,118,37,81,305,0,301802
14000US06037301900,140,6,37,3094,147,118,118,0,0,0,0,29,20,0,0,0,9,2947,608,552,56,0,56,0,2339,671,372,170,202,1296,0,301900
14000US06037302002,140,6,37,1636,103,41,29,12,0,12,0,62,26,15,0,15,21,1533,293,174,111,0,111,8,1240,330,137,32,105,773,0,302002
14000US06037302003,140,6,37,1383,148,75,75,0,0,0,0,73,29,34,0,34,10,1235,302,292,10,10,0,0,933,342,136,55,81,455,0,302003
14000US06037302004,140,6,37,1639,81,31,31,0,0,0,0,50,13,7,7,0,30,1558,314,289,25,0,25,0,1244,562,174,56,118,508,0,302004
14000US06037302102,140,6,37,2549,192,134,103,0,0,0,31,58,14,32,32,0,12,2357,589,444,145,33,112,0,1768,475,264,43,221,1029,0,302102
14000US06037302103,140,6,37,1907,207,166,135,31,0,31,0,41,12,19,8,11,10,1700,439,307,132,63,69,0,1261,606,200,108,92,455,0,302103
14000US06037302104,140,6,37,1466,123,52,29,23,0,23,0,71,71,0,0,0,0,1343,341,231,101,36,65,9,1002,352,116,10,106,534,0,302104
14000US06037302201,140,6,37,1552,248,191,146,45,0,45,0,57,23,17,17,0,17,1304,258,160,98,18,80,0,1046,335,70,13,57,641,0,302201
14000US06037302202,140,6,37,1799,306,168,85,83,20,63,0,138,62,25,5,20,51,1493,366,292,74,10,64,0,1127,447,204,24,180,476,0,302202
14000US06037302301,140,6,37,1399,110,82,32,50,17,33,0,28,19,9,0,9,0,1289,397,331,66,0,66,0,892,362,218,82,136,312,0,302301
14000US06037302302,140,6,37,1705,228,144,98,46,0,46,0,84,35,26,0,26,23,1477,402,285,117,29,88,0,1075,247,193,58,135,635,0,302302
14000US06037302401,140,6,37,2181,183,103,66,37,0,37,0,80,16,16,0,16,48,1998,500,316,158,73,85,26,1498,510,296,141,155,692,0,302401
14000US06037302503,140,6,37,1464,138,113,113,0,0,0,0,25,9,0,0,0,16,1326,409,325,84,22,62,0,917,414,199,30,169,304,0,302503
14000US06037302504,140,6,37,1475,258,146,60,86,41,45,0,112,70,26,0,26,16,1217,449,241,187,114,73,21,768,219,195,19,176,354,0,302504
14000US06037302505,140,6,37,1343,169,131,68,63,30,33,0,38,25,8,0,8,5,1174,370,296,74,0,74,0,804,190,125,40,85,489,0,302505
14000US06037302506,140,6,37,1349,112,75,75,0,0,0,0,37,0,28,21,7,9,1237,342,163,179,34,145,0,895,233,89,40,49,573,0,302506
14000US06037310100,140,6,37,1960,31,31,7,24,0,24,0,0,0,0,0,0,0,1929,696,619,77,18,59,0,1233,704,202,45,157,327,0,310100
14000US06037310201,140,6,37,2074,128,67,67,0,0,0,0,61,0,31,0,31,30,1946,606,462,144,13,131,0,1340,515,156,83,73,669,0,310201
14000US06037310202,140,6,37,1735,67,47,40,7,7,0,0,20,8,12,12,0,0,1668,516,402,107,7,100,7,1152,342,184,88,96,626,0,310202
14000US06037310300,140,6,37,964,13,6,0,6,0,6,0,7,0,7,7,0,0,951,351,334,17,9,8,0,600,423,43,22,21,134,0,310300
14000US06037310400,140,6,37,1292,57,21,3,18,18,0,0,36,0,36,26,10,0,1235,328,214,102,32,70,12,907,369,149,43,106,389,0,310400
14000US06037310501,140,6,37,1131,39,22,12,10,0,10,0,17,0,8,0,8,9,1092,376,286,90,26,64,0,716,338,71,0,71,307,0,310501
14000US06037310601,140,6,37,2303,92,54,11,43,0,43,0,38,0,7,0,7,31,2211,695,489,206,66,140,0,1516,438,323,60,263,755,0,310601
14000US06037310602,140,6,37,1076,5,5,5,0,0,0,0,0,0,0,0,0,0,1071,281,231,50,13,37,0,790,268,84,41,43,438,0,310602
14000US06037310701,140,6,37,1133,24,4,4,0,0,0,0,20,11,0,0,0,9,1109,222,130,92,0,92,0,887,221,92,34,58,574,0,310701
14000US06037310702,140,6,37,3454,99,73,73,0,0,0,0,26,11,0,0,0,15,3355,582,387,195,46,149,0,2773,712,267,33,234,1794,0,310702
14000US06037310703,140,6,37,2070,166,166,66,100,11,89,0,0,0,0,0,0,0,1904,314,269,45,0,45,0,1590,531,345,221,124,714,0,310703
14000US06037310800,140,6,37,1934,40,21,8,13,0,13,0,19,0,11,0,11,8,1894,689,527,162,64,98,0,1205,371,153,83,70,681,0,310800
14000US06037310900,140,6,37,2396,69,0,0,0,0,0,0,69,0,51,51,0,18,2327,660,430,230,36,194,0,1667,742,201,37,164,724,0,310900
14000US06037311000,140,6,37,1455,6,6,0,6,0,6,0,0,0,0,0,0,0,1449,489,393,96,20,76,0,960,323,144,23,121,493,0,311000
14000US06037311100,140,6,37,1289,54,24,24,0,0,0,0,30,22,8,0,8,0,1235,430,376,54,27,27,0,805,360,180,48,132,265,0,311100
14000US06037311200,140,6,37,1169,29,0,0,0,0,0,0,29,0,10,0,10,19,1140,450,283,135,113,22,32,690,166,92,22,70,432,0,311200
14000US06037311300,140,6,37,1439,28,10,6,4,4,0,0,18,0,10,10,0,8,1411,455,328,127,4,123,0,956,413,55,26,29,488,0,311300
14000US06037311400,140,6,37,954,10,4,0,0,0,0,4,6,0,0,0,0,6,944,300,225,75,27,48,0,644,214,57,9,48,373,0,311400
14000US06037311500,140,6,37,2400,0,0,0,0,0,0,0,0,0,0,0,0,0,2400,667,532,135,46,89,0,1733,576,136,62,74,1021,0,311500
14000US06037311600,140,6,37,3886,0,0,0,0,0,0,0,0,0,0,0,0,0,3886,726,465,250,49,201,11,3160,690,170,27,143,2300,0,311600
14000US06037311700,140,6,37,2403,25,25,0,25,0,25,0,0,0,0,0,0,0,2378,674,449,225,15,210,0,1704,615,190,92,98,899,0,311700
14000US06037311801,140,6,37,1246,73,24,9,15,0,15,0,49,12,12,12,0,25,1173,411,284,127,44,83,0,762,136,83,8,75,543,0,311801
14000US06037311802,140,6,37,1303,165,149,56,93,17,76,0,16,15,1,0,1,0,1138,299,202,97,56,41,0,839,220,111,65,46,508,0,311802
14000US06037320000,140,6,37,0,0,0,0,0,0,0,0,0,0,0,0,0,0,0,0,0,0,0,0,0,0,0,0,0,0,0,0,320000
14000US06037320100,140,6,37,1796,136,116,29,78,17,61,9,20,20,0,0,0,0,1660,934,683,237,98,139,14,726,392,182,42,140,152,0,320100
14000US06037320201,140,6,37,991,114,73,10,63,21,42,0,41,41,0,0,0,0,877,421,201,220,43,177,0,456,75,38,8,30,343,0,320201
14000US06037320202,140,6,37,1568,166,138,25,113,20,93,0,28,0,0,0,0,28,1402,751,538,213,72,141,0,651,347,103,29,74,201,0,320202
14000US06037320300,140,6,37,1821,222,170,95,75,23,52,0,52,0,34,14,20,18,1599,676,385,291,135,156,0,923,253,247,96,151,423,0,320300
14000US06037400204,140,6,37,2133,0,0,0,0,0,0,0,0,0,0,0,0,0,2133,776,648,128,25,103,0,1357,918,104,0,104,335,0,400204
14000US06037400205,140,6,37,1007,0,0,0,0,0,0,0,0,0,0,0,0,0,1007,393,353,40,31,9,0,614,399,63,54,9,152,0,400205
14000US06037400206,140,6,37,1762,39,0,0,0,0,0,0,39,39,0,0,0,0,1723,565,501,64,21,43,0,1158,934,50,30,20,174,0,400206
14000US06037400207,140,6,37,1464,19,19,0,19,8,11,0,0,0,0,0,0,0,1445,487,431,56,29,27,0,958,621,134,52,82,203,0,400207
14000US06037400302,140,6,37,1132,43,0,0,0,0,0,0,43,25,0,0,0,18,1089,318,217,76,44,32,25,771,284,56,22,34,431,0,400302
14000US06037400304,140,6,37,2463,37,11,11,0,0,0,0,26,14,0,0,0,12,2426,872,493,337,64,273,42,1554,659,223,93,130,672,0,400304
14000US06037400402,140,6,37,1342,18,18,12,6,0,6,0,0,0,0,0,0,0,1324,529,384,145,66,79,0,795,446,45,9,36,304,0,400402
14000US06037400403,140,6,37,1347,10,0,0,0,0,0,0,10,10,0,0,0,0,1337,487,381,106,25,81,0,850,442,82,9,73,326,0,400403
14000US06037400404,140,6,37,1380,29,29,4,25,0,25,0,0,0,0,0,0,0,1351,520,468,52,42,10,0,831,553,97,40,57,181,0,400404
14000US06037400501,140,6,37,681,5,5,0,5,0,5,0,0,0,0,0,0,0,676,241,219,22,18,4,0,435,283,59,5,54,93,0,400501
14000US06037400602,140,6,37,1312,100,62,7,55,0,55,0,38,0,38,7,31,0,1212,408,260,148,48,100,0,804,399,163,62,101,242,0,400602
14000US06037400603,140,6,37,1690,49,43,8,24,0,24,11,6,0,6,0,6,0,1641,577,375,202,70,132,0,1064,429,135,46,89,500,0,400603
14000US06037400604,140,6,37,940,94,79,47,32,0,32,0,15,0,15,11,4,0,846,247,217,30,0,30,0,599,208,86,27,59,305,0,400604
14000US06037400800,140,6,37,835,0,0,0,0,0,0,0,0,0,0,0,0,0,835,195,179,16,0,16,0,640,222,61,19,42,357,0,400800
14000US06037400900,140,6,37,1407,52,23,0,23,0,23,0,29,19,10,0,10,0,1355,465,377,88,9,79,0,890,335,86,0,86,469,0,400900
14000US06037401001,140,6,37,1006,12,8,6,2,0,2,0,4,0,0,0,0,4,994,389,345,44,15,29,0,605,384,52,25,27,169,0,401001
14000US06037401002,140,6,37,1638,0,0,0,0,0,0,0,0,0,0,0,0,0,1638,542,412,130,60,70,0,1096,399,64,36,28,633,0,401002
14000US06037401101,140,6,37,1917,85,56,13,43,0,43,0,29,15,0,0,0,14,1832,480,335,145,31,114,0,1352,512,221,53,168,619,0,401101
14000US06037401102,140,6,37,1058,47,30,0,30,0,30,0,17,0,0,0,0,17,1011,340,198,142,29,113,0,671,202,139,55,84,330,0,401102
14000US06037401201,140,6,37,1078,13,13,0,13,0,13,0,0,0,0,0,0,0,1065,396,348,48,23,25,0,669,370,98,26,72,201,0,401201
14000US06037401202,140,6,37,1317,74,74,45,29,0,29,0,0,0,0,0,0,0,1243,591,352,239,25,214,0,652,296,83,35,48,273,0,401202
14000US06037401203,140,6,37,1651,99,67,22,45,0,45,0,32,14,18,18,0,0,1552,651,483,168,64,104,0,901,517,153,10,143,231,0,401203
14000US06037401303,140,6,37,787,7,7,7,0,0,0,0,0,0,0,0,0,0,780,284,158,126,33,93,0,496,269,80,13,67,147,0,401303
14000US06037401304,140,6,37,2194,0,0,0,0,0,0,0,0,0,0,0,0,0,2194,545,497,48,28,20,0,1649,952,81,21,60,616,0,401304
14000US06037401311,140,6,37,2235,42,19,19,0,0,0,0,23,0,11,0,11,12,2193,761,445,272,95,177,44,1432,673,82,7,75,677,0,401311
14000US06037401312,140,6,37,1804,44,20,14,6,0,6,0,24,0,11,0,11,13,1760,505,406,99,6,93,0,1255,609,171,12,159,475,0,401312
14000US06037401500,140,6,37,1733,150,120,59,61,22,39,0,30,0,30,0,30,0,1583,591,434,157,74,83,0,992,376,132,30,102,484,0,401500
14000US06037401601,140,6,37,2075,28,28,18,10,0,10,0,0,0,0,0,0,0,2047,412,314,98,0,98,0,1635,651,197,30,167,787,0,401601
14000US06037401602,140,6,37,1814,132,89,9,80,0,80,0,43,8,35,25,10,0,1682,653,362,283,115,168,8,1029,463,217,69,148,349,0,401602
14000US06037401603,140,6,37,1207,59,40,19,21,21,0,0,19,8,0,0,0,11,1148,224,155,69,21,48,0,924,366,35,3,32,523,0,401603
14000US06037401701,140,6,37,1635,40,5,5,0,0,0,0,35,0,9,0,9,26,1595,371,335,36,0,36,0,1224,466,100,25,75,658,0,401701
14000US06037401703,140,6,37,1411,169,103,44,59,9,50,0,66,0,37,0,37,29,1242,502,251,241,69,172,10,740,236,62,29,33,442,0,401703
14000US06037401704,140,6,37,1938,179,132,27,105,0,105,0,47,0,0,0,0,47,1759,592,463,129,58,71,0,1167,246,124,39,85,797,0,401704
14000US06037401800,140,6,37,2655,54,54,29,25,0,25,0,0,0,0,0,0,0,2601,754,653,101,0,101,0,1847,925,168,79,89,754,0,401800
14000US06037401901,140,6,37,152,4,0,0,0,0,0,0,4,0,0,0,0,4,148,33,28,5,0,5,0,115,31,31,31,0,53,0,401901
14000US06037401902,140,6,37,2572,16,16,16,0,0,0,0,0,0,0,0,0,0,2556,501,335,166,49,117,0,2055,708,158,15,143,1189,0,401902
14000US06037402001,140,6,37,1070,149,149,79,70,0,70,0,0,0,0,0,0,0,921,360,257,103,7,96,0,561,238,49,0,49,274,0,402001
14000US06037402002,140,6,37,1466,48,35,35,0,0,0,0,13,2,0,0,0,11,1418,460,402,58,0,58,0,958,291,10,10,0,657,0,402002
14000US06037402101,140,6,37,1092,55,55,17,38,0,38,0,0,0,0,0,0,0,1037,625,510,115,50,65,0,412,138,78,25,53,196,0,402101
14000US06037402102,140,6,37,1232,169,169,52,117,25,92,0,0,0,0,0,0,0,1063,507,360,147,44,103,0,556,223,117,0,117,216,0,402102
14000US06037402200,140,6,37,2068,83,83,43,40,12,28,0,0,0,0,0,0,0,1985,610,402,208,87,121,0,1375,663,235,106,129,477,0,402200
14000US06037402301,140,6,37,1280,179,173,119,54,31,23,0,6,0,0,0,0,6,1101,625,466,159,56,103,0,476,269,98,75,23,109,0,402301
14000US06037402303,140,6,37,1135,206,199,71,106,24,82,22,7,7,0,0,0,0,929,459,241,218,168,50,0,470,206,89,24,65,175,0,402303
14000US06037402304,140,6,37,953,246,238,109,129,8,121,0,8,0,5,0,5,3,707,390,192,198,45,153,0,317,66,123,53,70,128,0,402304
14000US06037402402,140,6,37,1922,194,194,194,0,0,0,0,0,0,0,0,0,0,1728,676,404,272,45,227,0,1052,373,239,117,122,440,0,402402
14000US06037402403,140,6,37,1012,18,18,18,0,0,0,0,0,0,0,0,0,0,994,459,343,116,42,74,0,535,148,111,10,101,276,0,402403
14000US06037402404,140,6,37,4,0,0,0,0,0,0,0,0,0,0,0,0,0,4,0,0,0,0,0,0,4,0,4,4,0,0,0,402404
14000US06037402405,140,6,37,639,48,33,33,0,0,0,0,15,0,7,0,7,8,591,325,222,103,69,34,0,266,114,65,11,54,87,0,402405
14000US06037402406,140,6,37,1077,144,136,89,47,9,38,0,8,8,0,0,0,0,933,372,293,79,35,44,0,561,171,109,28,81,281,0,402406
14000US06037402501,140,6,37,1268,319,285,117,168,33,135,0,34,0,0,0,0,34,949,475,357,118,37,81,0,474,70,116,37,79,288,0,402501
14000US06037402502,140,6,37,1686,312,263,175,88,25,63,0,49,0,36,10,26,13,1374,640,469,171,81,90,0,734,340,206,41,165,188,0,402502
14000US06037402600,140,6,37,2455,256,229,46,183,0,183,0,27,0,10,0,10,17,2199,869,586,283,53,230,0,1330,352,89,19,70,889,0,402600
14000US06037402702,140,6,37,1516,442,415,121,294,52,242,0,27,0,6,0,6,21,1074,489,364,125,57,68,0,585,207,160,64,96,218,0,402702
14000US06037402703,140,6,37,1193,160,111,44,67,31,36,0,49,30,19,0,19,0,1033,473,330,143,55,88,0,560,220,88,43,45,252,0,402703
14000US06037402705,140,6,37,887,59,39,13,26,5,21,0,20,20,0,0,0,0,828,373,216,157,58,99,0,455,186,78,29,49,191,0,402705
14000US06037402706,140,6,37,973,79,79,13,66,12,54,0,0,0,0,0,0,0,894,454,361,88,25,63,5,440,118,167,47,120,155,0,402706
14000US06037402801,140,6,37,1100,306,291,20,271,62,209,0,15,6,9,0,9,0,794,508,327,181,34,147,0,286,122,73,17,56,91,0,402801
14000US06037402803,140,6,37,743,79,79,44,35,0,35,0,0,0,0,0,0,0,664,485,317,157,69,88,11,179,106,27,27,0,46,0,402803
14000US06037402804,140,6,37,947,294,259,149,110,38,72,0,35,0,21,17,4,14,653,351,223,128,45,83,0,302,154,53,33,20,95,0,402804
14000US06037402902,140,6,37,1451,247,219,69,150,9,141,0,28,0,28,15,13,0,1204,725,458,247,159,88,20,479,189,68,15,53,222,0,402902
14000US06037402903,140,6,37,998,230,192,80,112,41,71,0,38,38,0,0,0,0,768,361,267,94,14,80,0,407,183,73,8,65,151,0,402903
14000US06037402904,140,6,37,823,92,80,57,23,21,2,0,12,5,0,0,0,7,731,298,219,79,16,63,0,433,162,166,80,86,105,0,402904
14000US06037403000,140,6,37,1559,176,154,49,105,45,60,0,22,0,22,13,9,0,1383,781,639,142,0,142,0,602,343,67,15,52,192,0,403000
14000US06037403200,140,6,37,0,0,0,0,0,0,0,0,0,0,0,0,0,0,0,0,0,0,0,0,0,0,0,0,0,0,0,0,403200
14000US06037403303,140,6,37,745,7,7,7,0,0,0,0,0,0,0,0,0,0,738,264,179,85,3,82,0,474,255,103,42,61,116,0,403303
14000US06037403304,140,6,37,1595,11,11,0,11,11,0,0,0,0,0,0,0,0,1584,521,361,160,53,107,0,1063,781,112,94,18,170,0,403304
14000US06037403305,140,6,37,681,0,0,0,0,0,0,0,0,0,0,0,0,0,681,309,255,54,34,20,0,372,256,31,8,23,85,0,403305
14000US06037403312,140,6,37,1549,48,48,0,48,37,11,0,0,0,0,0,0,0,1501,638,488,150,19,131,0,863,452,217,87,130,194,0,403312
14000US06037403316,140,6,37,2344,29,15,15,0,0,0,0,14,14,0,0,0,0,2315,833,729,104,35,69,0,1482,717,188,46,142,577,0,403316
14000US06037403317,140,6,37,1376,23,23,7,16,0,16,0,0,0,0,0,0,0,1353,305,283,22,16,6,0,1048,583,106,56,50,359,0,403317
14000US06037403318,140,6,37,1893,62,15,8,7,0,7,0,47,39,0,0,0,8,1831,761,498,263,105,158,0,1070,607,225,65,160,238,0,403318
14000US06037403319,140,6,37,1572,29,24,14,10,0,10,0,5,0,0,0,0,5,1543,528,447,74,0,74,7,1015,383,109,55,54,523,0,403319
14000US06037403320,140,6,37,1607,15,0,0,0,0,0,0,15,7,8,0,8,0,1592,571,505,66,23,43,0,1021,696,121,31,90,204,0,403320
14000US06037403321,140,6,37,1859,53,34,9,25,0,25,0,19,10,9,0,9,0,1806,646,504,142,0,142,0,1160,682,134,49,85,344,0,403321
14000US06037403322,140,6,37,1246,0,0,0,0,0,0,0,0,0,0,0,0,0,1246,547,392,136,50,86,19,699,320,165,19,146,214,0,403322
14000US06037403323,140,6,37,1651,18,0,0,0,0,0,0,18,0,9,0,9,9,1633,682,372,299,57,242,11,951,565,116,59,57,270,0,403323
14000US06037403324,140,6,37,2093,31,31,0,31,31,0,0,0,0,0,0,0,0,2062,826,764,62,18,44,0,1236,727,254,122,132,255,0,403324
14000US06037403325,140,6,37,1453,44,44,44,0,0,0,0,0,0,0,0,0,0,1409,510,401,102,24,78,7,899,516,164,55,109,219,0,403325
14000US06037403401,140,6,37,1491,33,17,8,9,0,9,0,16,7,9,9,0,0,1458,581,486,87,10,77,8,877,477,160,60,100,240,0,403401
14000US06037403402,140,6,37,985,14,14,14,0,0,0,0,0,0,0,0,0,0,971,445,343,98,13,85,4,526,352,50,35,15,124,0,403402
14000US06037403403,140,6,37,1442,0,0,0,0,0,0,0,0,0,0,0,0,0,1442,641,487,154,45,109,0,801,577,114,47,67,110,0,403403
14000US06037403404,140,6,37,760,0,0,0,0,0,0,0,0,0,0,0,0,0,760,290,261,29,23,6,0,470,326,54,16,38,90,0,403404
14000US06037403405,140,6,37,498,7,7,0,7,0,7,0,0,0,0,0,0,0,491,183,152,31,22,9,0,308,235,20,0,20,53,0,403405
14000US06037403406,140,6,37,812,4,4,4,0,0,0,0,0,0,0,0,0,0,808,362,321,41,5,36,0,446,258,67,57,10,121,0,403406
14000US06037403407,140,6,37,620,0,0,0,0,0,0,0,0,0,0,0,0,0,620,274,210,54,0,54,10,346,308,24,13,11,14,0,403407
14000US06037403408,140,6,37,1873,36,36,23,13,0,13,0,0,0,0,0,0,0,1837,596,536,60,18,42,0,1241,797,212,29,183,232,0,403408
14000US06037403500,140,6,37,628,11,0,0,0,0,0,0,11,0,0,0,0,11,617,140,80,60,17,43,0,477,223,20,16,4,234,0,403500
14000US06037403600,140,6,37,2138,87,75,41,34,0,34,0,12,0,12,0,12,0,2051,742,486,256,78,178,0,1309,727,177,121,56,405,0,403600
14000US06037403702,140,6,37,1102,43,43,21,22,0,22,0,0,0,0,0,0,0,1059,270,165,105,29,76,0,789,420,76,29,47,293,0,403702
14000US06037403703,140,6,37,1455,18,18,10,8,0,8,0,0,0,0,0,0,0,1437,493,425,68,0,68,0,944,587,88,29,59,269,0,403703
14000US06037403721,140,6,37,1650,36,13,13,0,0,0,0,23,11,12,0,12,0,1614,658,465,193,22,171,0,956,387,138,19,119,431,0,403721
14000US06037403722,140,6,37,1631,243,196,53,143,70,73,0,47,11,0,0,0,36,1388,668,372,249,46,203,47,720,281,126,16,110,313,0,403722
14000US06037403801,140,6,37,1872,154,115,36,79,0,79,0,39,11,28,0,28,0,1718,618,425,193,44,149,0,1100,422,187,35,152,491,0,403801
14000US06037403802,140,6,37,1937,121,84,15,69,3,66,0,37,10,9,9,0,18,1816,772,534,238,105,133,0,1044,344,220,48,172,480,0,403802
14000US06037403901,140,6,37,909,32,32,13,19,15,4,0,0,0,0,0,0,0,877,352,222,130,28,102,0,525,276,77,17,60,172,0,403901
14000US06037403902,140,6,37,1404,59,42,18,24,0,24,0,17,0,17,0,17,0,1345,503,216,279,51,228,8,842,484,101,68,33,257,0,403902
14000US06037404000,140,6,37,1326,108,35,14,21,0,21,0,73,0,73,25,48,0,1218,557,393,164,71,93,0,661,352,127,96,31,182,0,404000
14000US06037404100,140,6,37,1336,92,92,54,38,0,38,0,0,0,0,0,0,0,1244,675,497,178,93,85,0,569,263,75,8,67,231,0,404100
14000US06037404201,140,6,37,936,220,220,69,151,36,115,0,0,0,0,0,0,0,716,389,210,179,55,124,0,327,122,57,0,57,148,0,404201
14000US06037404202,140,6,37,769,34,34,0,34,0,34,0,0,0,0,0,0,0,735,267,155,112,35,77,0,468,161,74,27,47,233,0,404202
14000US06037404301,140,6,37,1373,128,120,23,97,11,86,0,8,0,0,0,0,8,1245,639,354,285,38,247,0,606,245,93,51,42,268,0,404301
14000US06037404302,140,6,37,556,24,24,16,8,0,8,0,0,0,0,0,0,0,532,211,175,36,16,20,0,321,139,50,16,34,132,0,404302
14000US06037404401,140,6,37,929,123,123,36,81,26,55,6,0,0,0,0,0,0,806,334,215,119,41,78,0,472,264,46,17,29,162,0,404401
14000US06037404402,140,6,37,1157,8,0,0,0,0,0,0,8,0,0,0,0,8,1149,689,577,79,9,70,33,460,172,152,96,56,136,0,404402
14000US06037404501,140,6,37,583,114,92,50,42,0,42,0,22,0,12,12,0,10,469,262,135,127,26,101,0,207,128,30,7,23,49,0,404501
14000US06037404503,140,6,37,714,21,16,4,12,12,0,0,5,5,0,0,0,0,693,374,228,146,63,83,0,319,133,67,58,9,119,0,404503
14000US06037404504,140,6,37,1278,155,138,39,99,0,99,0,17,17,0,0,0,0,1123,568,321,247,108,139,0,555,148,136,70,66,271,0,404504
14000US06037404600,140,6,37,357,32,29,5,24,2,22,0,3,0,3,0,3,0,325,160,117,43,12,31,0,165,88,12,0,12,65,0,404600
14000US06037404701,140,6,37,1279,190,129,58,71,18,53,0,61,0,43,0,43,18,1089,470,216,254,108,146,0,619,347,145,67,78,127,0,404701
14000US06037404702,140,6,37,1340,256,256,184,72,0,72,0,0,0,0,0,0,0,1084,621,416,205,22,183,0,463,238,142,9,133,83,0,404702
14000US06037404703,140,6,37,714,145,124,43,81,5,76,0,21,4,13,0,13,4,569,342,244,98,31,67,0,227,125,63,27,36,39,0,404703
14000US06037404801,140,6,37,1768,285,208,107,101,22,79,0,77,27,29,6,23,21,1483,700,517,183,41,142,0,783,330,273,132,141,180,0,404801
14000US06037404802,140,6,37,1053,128,122,53,69,27,42,0,6,6,0,0,0,0,925,518,341,167,8,159,10,407,165,74,5,69,168,0,404802
14000US06037404803,140,6,37,420,71,41,27,14,0,14,0,30,23,7,0,7,0,349,153,99,54,31,23,0,196,84,56,0,56,56,0,404803
14000US06037404901,140,6,37,1294,97,68,23,45,12,33,0,29,9,20,9,11,0,1197,584,530,54,13,41,0,613,343,173,53,120,97,0,404901
14000US06037404902,140,6,37,906,120,120,45,75,0,75,0,0,0,0,0,0,0,786,418,309,109,19,90,0,368,281,43,4,39,44,0,404902
14000US06037404903,140,6,37,629,79,41,33,8,0,8,0,38,0,8,0,8,30,550,204,150,54,12,42,0,346,184,111,18,93,51,0,404903
14000US06037405001,140,6,37,1333,127,99,48,51,0,51,0,28,14,0,0,0,14,1206,753,531,211,103,108,11,453,255,116,34,82,82,0,405001
14000US06037405002,140,6,37,666,124,114,48,66,4,62,0,10,6,0,0,0,4,542,340,235,105,42,63,0,202,96,56,39,17,50,0,405002
14000US06037405101,140,6,37,1142,158,126,73,53,23,30,0,32,22,10,10,0,0,984,459,311,148,7,141,0,525,182,216,124,92,127,0,405101
14000US06037405102,140,6,37,1321,221,191,59,132,0,132,0,30,30,0,0,0,0,1100,356,247,109,40,69,0,744,242,224,50,174,278,0,405102
14000US06037405201,140,6,37,1260,166,125,47,78,26,52,0,41,12,29,29,0,0,1094,585,331,254,61,193,0,509,275,110,73,37,124,0,405201
14000US06037405202,140,6,37,1180,202,192,117,75,21,54,0,10,0,0,0,0,10,978,575,381,194,51,143,0,403,184,82,41,41,137,0,405202
14000US06037405203,140,6,37,725,85,41,22,19,0,19,0,44,11,33,0,33,0,640,300,200,100,56,44,0,340,190,76,28,48,74,0,405203
14000US06037405301,140,6,37,1073,70,59,15,44,0,44,0,11,11,0,0,0,0,1003,436,324,112,0,112,0,567,118,168,42,126,281,0,405301
14000US06037405302,140,6,37,1519,109,80,16,64,0,64,0,29,29,0,0,0,0,1410,629,496,133,16,117,0,781,408,147,7,140,226,0,405302
14000US06037405400,140,6,37,1278,56,56,47,9,9,0,0,0,0,0,0,0,0,1222,583,364,219,90,129,0,639,311,123,30,93,205,0,405400
14000US06037405500,140,6,37,1970,101,58,6,52,0,52,0,43,0,11,0,11,32,1869,794,459,335,8,327,0,1075,350,141,39,102,584,0,405500
14000US06037405600,140,6,37,1608,87,62,14,48,25,23,0,25,16,9,0,9,0,1521,495,369,126,36,90,0,1026,424,238,41,197,364,0,405600
14000US06037405701,140,6,37,1041,19,6,0,6,0,6,0,13,0,13,0,13,0,1022,395,349,46,11,35,0,627,301,110,62,48,216,0,405701
14000US06037405702,140,6,37,1520,60,50,14,36,0,36,0,10,0,10,10,0,0,1460,669,507,162,12,150,0,791,232,262,125,137,297,0,405702
14000US06037405800,140,6,37,1632,111,111,57,54,0,54,0,0,0,0,0,0,0,1521,574,370,204,63,141,0,947,485,175,42,133,287,0,405800
14000US06037405900,140,6,37,1157,64,58,13,45,20,25,0,6,0,6,0,6,0,1093,552,403,149,39,110,0,541,290,27,10,17,224,0,405900
14000US06037406000,140,6,37,1535,128,112,37,75,62,13,0,16,0,8,0,8,8,1407,590,378,212,49,163,0,817,269,113,50,63,435,0,406000
14000US06037406101,140,6,37,1119,73,62,8,54,0,54,0,11,0,0,0,0,11,1046,407,239,168,40,128,0,639,224,45,14,31,370,0,406101
14000US06037406102,140,6,37,2151,100,100,34,66,0,66,0,0,0,0,0,0,0,2051,695,375,320,55,265,0,1356,329,321,110,211,706,0,406102
14000US06037406200,140,6,37,1782,89,38,27,11,0,11,0,51,7,3,3,0,41,1693,595,422,173,13,160,0,1098,374,195,41,154,529,0,406200
14000US06037406300,140,6,37,1727,102,102,13,89,8,81,0,0,0,0,0,0,0,1625,519,404,115,0,115,0,1106,601,124,56,68,381,0,406300
14000US06037406402,140,6,37,604,35,16,16,0,0,0,0,19,19,0,0,0,0,569,208,156,52,6,46,0,361,210,47,27,20,104,0,406402
14000US06037406411,140,6,37,524,34,28,6,22,22,0,0,6,0,6,0,6,0,490,223,171,52,24,28,0,267,185,39,13,26,43,0,406411
14000US06037406412,140,6,37,809,7,0,0,0,0,0,0,7,0,7,0,7,0,802,340,267,73,34,39,0,462,217,51,17,34,194,0,406412
14000US06037406500,140,6,37,1965,75,61,19,42,0,42,0,14,0,0,0,0,14,1890,827,529,298,63,235,0,1063,342,217,112,105,504,0,406500
14000US06037406601,140,6,37,1495,18,11,11,0,0,0,0,7,7,0,0,0,0,1477,641,590,51,6,45,0,836,419,161,72,89,256,0,406601
14000US06037406602,140,6,37,1256,138,110,64,46,21,25,0,28,20,0,0,0,8,1118,498,408,90,24,66,0,620,280,115,45,70,225,0,406602
14000US06037406701,140,6,37,943,73,39,39,0,0,0,0,34,0,34,34,0,0,870,467,396,71,0,71,0,403,216,74,21,53,113,0,406701
14000US06037406702,140,6,37,1686,167,94,36,58,5,53,0,73,0,21,0,21,52,1519,756,411,345,185,160,0,763,361,152,44,108,250,0,406702
14000US06037406800,140,6,37,1277,116,91,9,82,22,60,0,25,9,6,0,6,10,1161,481,406,75,19,56,0,680,336,187,86,101,157,0,406800
14000US06037406901,140,6,37,1182,155,155,93,62,22,40,0,0,0,0,0,0,0,1027,499,279,220,143,77,0,528,278,124,91,33,126,0,406901
14000US06037406902,140,6,37,865,47,35,14,21,0,21,0,12,0,12,0,12,0,818,379,271,108,29,79,0,439,146,138,28,110,155,0,406902
14000US06037407001,140,6,37,1142,140,140,96,44,0,44,0,0,0,0,0,0,0,1002,553,344,192,42,150,17,449,213,190,40,150,46,0,407001
14000US06037407002,140,6,37,727,31,26,12,14,0,14,0,5,5,0,0,0,0,696,369,254,115,71,44,0,327,142,132,56,76,53,0,407002
14000US06037407101,140,6,37,1165,144,88,51,37,0,37,0,56,0,56,16,40,0,1021,575,493,82,40,42,0,446,270,59,26,33,117,0,407101
14000US06037407102,140,6,37,1219,114,64,64,0,0,0,0,50,22,12,9,3,16,1105,530,364,166,63,103,0,575,324,109,62,47,142,0,407102
14000US06037407200,140,6,37,1536,204,204,69,135,11,124,0,0,0,0,0,0,0,1332,554,388,152,19,133,14,778,322,250,102,148,206,0,407200
14000US06037407301,140,6,37,1068,57,49,30,19,0,19,0,8,8,0,0,0,0,1011,542,362,171,54,117,9,469,192,172,48,124,105,0,407301
14000US06037407302,140,6,37,714,78,78,51,27,21,6,0,0,0,0,0,0,0,636,331,270,61,33,28,0,305,186,109,31,78,10,0,407302
14000US06037407400,140,6,37,560,25,25,10,15,0,15,0,0,0,0,0,0,0,535,192,158,34,5,29,0,343,166,74,5,69,103,0,407400
14000US06037407501,140,6,37,970,136,112,88,24,0,24,0,24,6,18,0,18,0,834,447,300,138,23,115,9,387,273,31,18,13,83,0,407501
14000US06037407502,140,6,37,821,139,134,62,72,44,28,0,5,0,0,0,0,5,682,376,315,61,24,37,0,306,159,69,27,42,78,0,407502
14000US06037407601,140,6,37,1130,83,76,7,69,10,59,0,7,0,0,0,0,7,1047,398,280,118,91,27,0,649,240,218,67,151,191,0,407601
14000US06037407602,140,6,37,927,100,81,62,19,5,14,0,19,4,15,15,0,0,827,520,410,110,54,56,0,307,166,69,6,63,72,0,407602
14000US06037407701,140,6,37,1159,193,183,46,137,29,108,0,10,10,0,0,0,0,966,429,302,127,54,73,0,537,134,129,79,50,274,0,407701
14000US06037407702,140,6,37,1581,119,81,13,68,30,38,0,38,0,38,31,7,0,1462,660,484,176,39,137,0,802,406,228,77,151,168,0,407702
14000US06037407801,140,6,37,1091,92,92,39,53,0,53,0,0,0,0,0,0,0,999,527,399,128,59,69,0,472,234,91,34,57,147,0,407801
14000US06037407802,140,6,37,822,28,28,25,3,0,3,0,0,0,0,0,0,0,794,435,312,123,59,64,0,359,142,148,74,74,69,0,407802
14000US06037407900,140,6,37,1443,146,125,68,57,0,57,0,21,7,14,0,14,0,1297,603,450,153,22,131,0,694,349,195,74,121,150,0,407900
14000US06037408003,140,6,37,1157,19,14,14,0,0,0,0,5,5,0,0,0,0,1138,566,508,58,11,47,0,572,355,116,49,67,101,0,408003
14000US06037408004,140,6,37,882,32,13,0,13,0,13,0,19,0,19,0,19,0,850,421,208,213,98,115,0,429,208,24,0,24,197,0,408004
14000US06037408005,140,6,37,1542,38,22,0,16,0,16,6,16,16,0,0,0,0,1504,621,388,222,27,195,11,883,545,151,38,113,187,0,408005
14000US06037408006,140,6,37,1063,71,71,7,64,0,64,0,0,0,0,0,0,0,992,385,252,133,7,126,0,607,264,135,31,104,208,0,408006
14000US06037408133,140,6,37,1614,89,89,60,29,0,29,0,0,0,0,0,0,0,1525,571,481,65,31,34,25,954,469,205,63,142,280,0,408133
14000US06037408134,140,6,37,843,11,5,0,5,0,5,0,6,6,0,0,0,0,832,307,251,56,0,56,0,525,355,36,20,16,134,0,408134
14000US06037408135,140,6,37,1208,59,50,0,50,0,50,0,9,0,0,0,0,9,1149,557,383,174,31,143,0,592,252,122,31,91,218,0,408135
14000US06037408136,140,6,37,1062,15,4,0,4,0,4,0,11,11,0,0,0,0,1047,378,250,128,46,82,0,669,395,129,52,77,145,0,408136
14000US06037408137,140,6,37,1223,109,91,46,45,0,45,0,18,0,18,8,10,0,1114,473,271,202,92,110,0,641,253,175,39,136,213,0,408137
14000US06037408138,140,6,37,1268,357,317,120,134,67,67,63,40,20,8,0,8,12,911,392,291,101,25,76,0,519,172,156,47,109,191,0,408138
14000US06037408139,140,6,37,742,90,70,32,38,0,38,0,20,16,4,4,0,0,652,337,266,71,18,53,0,315,110,121,40,81,84,0,408139
14000US06037408140,140,6,37,757,155,146,47,99,20,79,0,9,0,7,0,7,2,602,317,280,37,11,26,0,285,163,45,15,30,77,0,408140
14000US06037408141,140,6,37,1071,172,158,76,82,30,52,0,14,14,0,0,0,0,899,417,295,122,56,66,0,482,213,121,34,87,148,0,408141
14000US06037408202,140,6,37,453,24,24,7,17,5,12,0,0,0,0,0,0,0,429,214,130,84,19,65,0,215,75,54,29,25,86,0,408202
14000US06037408211,140,6,37,1748,148,117,78,39,0,39,0,31,31,0,0,0,0,1600,398,241,135,62,73,22,1202,633,209,104,105,360,0,408211
14000US06037408212,140,6,37,1304,66,51,0,51,21,30,0,15,5,5,5,0,5,1238,526,365,144,31,113,17,712,478,123,37,86,111,0,408212
14000US06037408301,140,6,37,1122,58,58,10,48,0,48,0,0,0,0,0,0,0,1064,498,426,72,14,58,0,566,311,72,48,24,183,0,408301
14000US06037408302,140,6,37,1068,21,0,0,0,0,0,0,21,21,0,0,0,0,1047,442,288,154,140,14,0,605,272,156,96,60,177,0,408302
14000US06037408303,140,6,37,1170,32,32,9,23,10,13,0,0,0,0,0,0,0,1138,511,275,236,66,170,0,627,268,107,8,99,252,0,408303
14000US06037408401,140,6,37,1204,93,86,29,57,0,57,0,7,0,0,0,0,7,1111,476,349,127,63,64,0,635,366,42,0,42,227,0,408401
14000US06037408402,140,6,37,1683,63,63,55,8,0,8,0,0,0,0,0,0,0,1620,474,397,77,17,60,0,1146,606,155,47,108,385,0,408402
14000US06037408501,140,6,37,803,20,20,7,9,0,9,4,0,0,0,0,0,0,783,306,157,149,80,69,0,477,267,90,19,71,120,0,408501
14000US06037408503,140,6,37,1980,25,25,15,10,0,10,0,0,0,0,0,0,0,1955,662,539,123,39,84,0,1293,739,274,89,185,280,0,408503
14000US06037408504,140,6,37,1549,82,59,32,27,0,27,0,23,8,10,0,10,5,1467,577,466,111,20,91,0,890,444,87,12,75,359,0,408504
14000US06037408505,140,6,37,799,7,7,7,0,0,0,0,0,0,0,0,0,0,792,309,244,65,4,61,0,483,252,109,41,68,122,0,408505
14000US06037408623,140,6,37,1001,12,3,3,0,0,0,0,9,0,9,0,9,0,989,300,221,79,33,46,0,689,354,134,33,101,201,0,408623
14000US06037408624,140,6,37,975,20,20,10,10,10,0,0,0,0,0,0,0,0,955,365,315,50,5,45,0,590,348,122,38,84,120,0,408624
14000US06037408625,140,6,37,1254,9,0,0,0,0,0,0,9,0,0,0,0,9,1245,472,333,139,42,97,0,773,349,191,49,142,233,0,408625
14000US06037408626,140,6,37,1458,0,0,0,0,0,0,0,0,0,0,0,0,0,1458,390,318,72,0,72,0,1068,505,294,127,167,269,0,408626
14000US06037408627,140,6,37,891,4,0,0,0,0,0,0,4,0,0,0,0,4,887,251,239,12,3,9,0,636,409,73,29,44,154,0,408627
14000US06037408628,140,6,37,1770,51,22,7,15,0,15,0,29,20,0,0,0,9,1719,395,341,54,36,18,0,1324,635,288,102,186,401,0,408628
14000US06037408629,140,6,37,917,0,0,0,0,0,0,0,0,0,0,0,0,0,917,345,281,64,0,64,0,572,297,135,45,90,140,0,408629
14000US06037408630,140,6,37,554,25,9,9,0,0,0,0,16,16,0,0,0,0,529,325,198,127,22,105,0,204,137,33,3,30,34,0,408630
14000US06037408631,140,6,37,1382,61,32,10,22,0,22,0,29,0,29,0,29,0,1321,485,308,170,63,107,7,836,490,188,49,139,158,0,408631
14000US06037408703,140,6,37,1934,41,32,32,0,0,0,0,9,0,0,0,0,9,1893,792,669,123,25,98,0,1101,815,191,120,71,95,0,408703
14000US06037408704,140,6,37,1013,8,0,0,0,0,0,0,8,0,8,0,8,0,1005,336,264,72,9,63,0,669,235,75,9,66,359,0,408704
14000US06037408705,140,6,37,1599,87,75,35,40,21,19,0,12,12,0,0,0,0,1512,504,460,44,0,44,0,1008,573,265,79,186,170,0,408705
14000US06037408706,140,6,37,495,12,12,12,0,0,0,0,0,0,0,0,0,0,483,152,133,19,5,14,0,331,228,50,39,11,53,0,408706
14000US06037408722,140,6,37,1254,27,27,16,11,0,11,0,0,0,0,0,0,0,1227,542,407,135,30,105,0,685,453,107,74,33,125,0,408722
14000US06037408723,140,6,37,806,36,18,2,16,0,16,0,18,18,0,0,0,0,770,338,242,96,0,96,0,432,226,127,42,85,79,0,408723
14000US06037408724,140,6,37,1447,235,198,29,149,43,106,20,37,0,37,0,37,0,1212,410,262,148,75,73,0,802,245,284,145,139,273,0,408724
14000US06037408800,140,6,37,1236,198,161,24,137,18,119,0,37,14,0,0,0,23,1038,333,226,107,0,107,0,705,137,67,36,31,501,0,408800
14000US06037430002,140,6,37,2352,84,73,17,56,9,47,0,11,0,0,0,0,11,2268,716,604,100,20,80,12,1552,497,335,105,230,720,0,430002
14000US06037430003,140,6,37,1520,41,21,21,0,0,0,0,20,13,7,0,7,0,1479,506,426,80,58,22,0,973,480,188,42,146,305,0,430003
14000US06037430101,140,6,37,1730,53,53,19,34,7,27,0,0,0,0,0,0,0,1677,449,285,164,33,131,0,1228,304,186,87,99,738,0,430101
14000US06037430102,140,6,37,1254,150,126,83,43,9,34,0,24,15,9,0,9,0,1104,480,363,82,27,55,35,624,280,142,17,125,202,0,430102
14000US06037430200,140,6,37,422,8,0,0,0,0,0,0,8,0,8,0,8,0,414,91,84,2,2,0,5,323,173,24,5,19,126,0,430200
14000US06037430301,140,6,37,1615,28,12,12,0,0,0,0,16,0,8,8,0,8,1587,514,360,148,75,73,6,1073,698,107,44,63,268,0,430301
14000US06037430302,140,6,37,2322,0,0,0,0,0,0,0,0,0,0,0,0,0,2322,840,596,244,99,145,0,1482,493,159,68,91,830,0,430302
14000US06037430400,140,6,37,1534,27,27,27,0,0,0,0,0,0,0,0,0,0,1507,606,481,125,27,98,0,901,659,61,9,52,181,0,430400
14000US06037430501,140,6,37,1696,18,0,0,0,0,0,0,18,0,0,0,0,18,1678,499,386,113,7,106,0,1179,549,73,18,55,557,0,430501
14000US06037430502,140,6,37,2854,12,0,0,0,0,0,0,12,0,12,0,12,0,2842,564,462,102,40,62,0,2278,1020,266,59,207,992,0,430502
14000US06037430600,140,6,37,1450,20,12,12,0,0,0,0,8,0,8,8,0,0,1430,626,589,37,0,37,0,804,457,76,31,45,271,0,430600
14000US06037430701,140,6,37,1961,9,9,9,0,0,0,0,0,0,0,0,0,0,1952,599,482,105,21,84,12,1353,724,102,23,79,527,0,430701
14000US06037430721,140,6,37,1180,0,0,0,0,0,0,0,0,0,0,0,0,0,1180,448,266,182,72,110,0,732,368,135,62,73,229,0,430721
14000US06037430723,140,6,37,1665,65,54,49,5,0,5,0,11,0,0,0,0,11,1600,535,390,145,30,115,0,1065,295,174,39,135,596,0,430723
14000US06037430724,140,6,37,1970,46,30,30,0,0,0,0,16,0,6,0,6,10,1924,707,546,139,19,120,22,1217,370,215,136,79,632,0,430724
14000US06037430801,140,6,37,2402,10,0,0,0,0,0,0,10,10,0,0,0,0,2392,1046,697,299,53,246,50,1346,367,245,127,118,734,0,430801
14000US06037430802,140,6,37,1429,0,0,0,0,0,0,0,0,0,0,0,0,0,1429,554,408,146,0,146,0,875,504,147,52,95,224,0,430802
14000US06037430803,140,6,37,1787,19,0,0,0,0,0,0,19,0,19,8,11,0,1768,627,533,94,0,94,0,1141,544,147,83,64,450,0,430803
14000US06037430901,140,6,37,1504,59,36,36,0,0,0,0,23,8,7,7,0,8,1445,610,328,282,77,205,0,835,248,151,91,60,436,0,430901
14000US06037430902,140,6,37,1644,53,27,0,27,0,27,0,26,12,14,0,14,0,1591,524,327,197,101,96,0,1067,349,197,89,108,521,0,430902
14000US06037431001,140,6,37,2516,180,93,12,81,19,62,0,87,0,0,0,0,87,2336,734,602,132,34,98,0,1602,473,264,71,193,865,0,431001
14000US06037431002,140,6,37,1251,36,23,0,23,0,23,0,13,7,0,0,0,6,1215,323,224,93,2,91,6,892,302,109,0,109,481,0,431002
14000US06037431100,140,6,37,2108,129,83,35,48,0,48,0,46,12,34,12,22,0,1979,728,539,189,98,91,0,1251,476,126,57,69,649,0,431100
14000US06037431200,140,6,37,1492,136,101,56,45,7,38,0,35,0,27,0,27,8,1356,608,474,134,46,88,0,748,286,167,44,123,295,0,431200
14000US06037431300,140,6,37,868,13,7,7,0,0,0,0,6,0,6,0,6,0,855,338,264,74,47,27,0,517,303,60,26,34,154,0,431300
14000US06037431400,140,6,37,1348,8,8,8,0,0,0,0,0,0,0,0,0,0,1340,375,320,55,0,55,0,965,401,89,16,73,475,0,431400
14000US06037431501,140,6,37,1537,63,44,0,44,0,44,0,19,10,0,0,0,9,1474,519,364,155,87,68,0,955,339,203,47,156,413,0,431501
14000US06037431502,140,6,37,1430,76,67,67,0,0,0,0,9,0,9,9,0,0,1354,501,378,123,9,114,0,853,491,123,25,98,239,0,431502
14000US06037431600,140,6,37,1265,15,15,0,15,0,15,0,0,0,0,0,0,0,1250,393,344,49,10,39,0,857,485,107,19,88,265,0,431600
14000US06037431700,140,6,37,1997,27,27,27,0,0,0,0,0,0,0,0,0,0,1970,775,579,196,0,196,0,1195,691,149,47,102,355,0,431700
14000US06037431800,140,6,37,1809,84,84,34,50,0,50,0,0,0,0,0,0,0,1725,761,540,221,50,171,0,964,462,244,88,156,258,0,431800
14000US06037431900,140,6,37,1331,42,30,17,13,0,13,0,12,12,0,0,0,0,1289,402,348,54,0,54,0,887,349,199,118,81,339,0,431900
14000US06037432000,140,6,37,2524,133,101,31,70,0,70,0,32,18,0,0,0,14,2391,850,747,103,6,97,0,1541,766,250,41,209,525,0,432000
14000US06037432101,140,6,37,1347,48,48,18,30,0,30,0,0,0,0,0,0,0,1299,461,395,66,0,66,0,838,496,117,27,90,225,0,432101
14000US06037432102,140,6,37,1680,10,10,10,0,0,0,0,0,0,0,0,0,0,1670,690,460,230,84,146,0,980,593,157,36,121,230,0,432102
14000US06037432201,140,6,37,1297,46,28,28,0,0,0,0,18,7,11,11,0,0,1251,448,348,100,79,21,0,803,271,135,37,98,397,0,432201
14000US06037432202,140,6,37,1288,39,0,0,0,0,0,0,39,8,31,11,20,0,1249,461,349,112,59,53,0,788,355,199,46,153,234,0,432202
14000US06037432300,140,6,37,1158,43,22,9,13,9,4,0,21,0,21,9,12,0,1115,415,279,136,53,83,0,700,187,234,123,111,279,0,432300
14000US06037432401,140,6,37,1017,191,153,63,90,0,90,0,38,11,21,21,0,6,826,413,253,160,67,93,0,413,200,88,43,45,125,0,432401
14000US06037432402,140,6,37,1786,126,102,43,59,22,37,0,24,0,10,0,10,14,1660,639,514,125,43,82,0,1021,474,182,101,81,365,0,432402
14000US06037432500,140,6,37,2296,254,155,71,75,49,26,9,99,42,39,17,22,18,2042,741,464,277,32,245,0,1301,559,365,120,245,377,0,432500
14000US06037432601,140,6,37,1682,187,135,39,96,23,73,0,52,33,19,12,7,0,1495,655,436,219,102,117,0,840,440,222,72,150,178,0,432601
14000US06037432602,140,6,37,1179,70,70,0,70,0,70,0,0,0,0,0,0,0,1109,402,290,71,19,52,41,707,301,192,23,169,214,0,432602
14000US06037432700,140,6,37,1247,43,43,26,17,0,17,0,0,0,0,0,0,0,1204,563,389,174,73,101,0,641,319,175,87,88,147,0,432700
14000US06037432801,140,6,37,876,95,77,6,71,26,45,0,18,6,6,0,6,6,781,214,129,85,53,32,0,567,258,109,58,51,200,0,432801
14000US06037432802,140,6,37,1448,281,201,141,60,16,44,0,80,16,28,0,28,36,1167,490,363,127,50,77,0,677,187,240,168,72,250,0,432802
14000US06037432901,140,6,37,1243,102,91,37,54,33,21,0,11,0,11,0,11,0,1141,528,360,168,59,109,0,613,226,208,117,91,179,0,432901
14000US06037432902,140,6,37,879,65,55,47,8,0,8,0,10,10,0,0,0,0,814,368,295,73,45,28,0,446,206,155,90,65,85,0,432902
14000US06037433101,140,6,37,637,79,72,23,49,0,49,0,7,7,0,0,0,0,558,139,100,39,0,39,0,419,218,102,31,71,99,0,433101
14000US06037433102,140,6,37,1171,223,217,42,148,53,95,27,6,0,6,0,6,0,948,371,243,128,30,98,0,577,192,225,60,165,160,0,433102
14000US06037433200,140,6,37,1575,179,133,71,62,9,53,0,46,22,15,0,15,9,1396,646,434,188,59,129,24,750,211,265,138,127,274,0,433200
14000US06037433302,140,6,37,418,112,105,58,47,0,47,0,7,0,7,0,7,0,306,148,126,22,8,14,0,158,72,30,24,6,56,0,433302
14000US06037433304,140,6,37,1345,74,74,48,26,0,26,0,0,0,0,0,0,0,1271,459,321,138,35,103,0,812,305,107,57,50,400,0,433304
14000US06037433305,140,6,37,1188,246,233,77,156,41,115,0,13,13,0,0,0,0,942,506,304,202,27,175,0,436,201,71,43,28,164,0,433305
14000US06037433306,140,6,37,778,106,86,22,64,32,32,0,20,0,6,0,6,14,672,376,230,146,37,109,0,296,172,64,15,49,60,0,433306
14000US06037433307,140,6,37,807,145,127,82,41,0,41,4,18,8,0,0,0,10,662,310,178,132,33,99,0,352,211,106,43,63,35,0,433307
14000US06037433401,140,6,37,657,133,110,80,30,12,18,0,23,0,17,11,6,6,524,230,151,79,56,23,0,294,120,81,33,48,93,0,433401
14000US06037433402,140,6,37,1139,266,258,126,106,40,66,26,8,0,0,0,0,8,873,404,221,183,42,141,0,469,209,105,85,20,155,0,433402
14000US06037433403,140,6,37,1179,203,203,116,87,50,37,0,0,0,0,0,0,0,976,394,273,121,42,79,0,582,324,133,52,81,125,0,433403
14000US06037433501,140,6,37,507,116,111,24,87,24,63,0,5,0,0,0,0,5,391,198,93,105,39,66,0,193,67,34,21,13,92,0,433501
14000US06037433503,140,6,37,704,84,84,12,72,19,53,0,0,0,0,0,0,0,620,284,111,173,135,38,0,336,134,62,6,56,140,0,433503
14000US06037433504,140,6,37,1071,227,182,106,76,25,51,0,45,14,0,0,0,31,844,406,274,132,84,48,0,438,169,179,85,94,90,0,433504
14000US06037433601,140,6,37,1170,106,99,78,21,11,10,0,7,0,0,0,0,7,1064,304,159,145,67,78,0,760,343,192,107,85,225,0,433601
14000US06037433602,140,6,37,768,64,24,6,18,12,6,0,40,23,7,0,7,10,704,222,166,56,0,56,0,482,169,122,45,77,191,0,433602
14000US06037433700,140,6,37,855,85,80,19,61,54,7,0,5,0,5,0,5,0,770,444,331,113,17,96,0,326,156,112,16,96,58,0,433700
14000US06037433801,140,6,37,1290,234,225,136,89,57,32,0,9,0,0,0,0,9,1056,513,327,177,54,123,9,543,263,127,20,107,153,0,433801
14000US06037433802,140,6,37,762,58,33,33,0,0,0,0,25,10,15,0,15,0,704,202,173,29,7,22,0,502,254,127,52,75,121,0,433802
14000US06037433901,140,6,37,1246,299,267,138,129,19,110,0,32,0,19,14,5,13,947,530,441,89,38,51,0,417,117,118,82,36,182,0,433901
14000US06037433902,140,6,37,939,124,94,35,55,4,51,4,30,10,20,0,20,0,815,258,168,90,34,56,0,557,233,137,67,70,187,0,433902
14000US06037434001,140,6,37,1042,101,92,32,60,21,39,0,9,0,9,0,9,0,941,472,308,164,88,76,0,469,205,167,74,93,97,0,434001
14000US06037434003,140,6,37,1073,223,215,117,98,72,26,0,8,0,8,0,8,0,850,459,273,186,67,119,0,391,170,112,83,29,109,0,434003
14000US06037434004,140,6,37,629,185,144,128,16,0,16,0,41,0,41,0,41,0,444,194,153,36,20,16,5,250,150,73,47,26,27,0,434004
14000US06037460000,140,6,37,1757,0,0,0,0,0,0,0,0,0,0,0,0,0,1757,542,462,72,22,50,8,1215,596,89,23,66,530,0,460000
14000US06037460100,140,6,37,2507,36,26,26,0,0,0,0,10,0,10,0,10,0,2471,635,427,208,121,87,0,1836,899,57,36,21,880,0,460100
14000US06037460200,140,6,37,2124,60,60,0,60,0,60,0,0,0,0,0,0,0,2064,467,306,161,0,161,0,1597,548,291,38,253,758,0,460200
14000US06037460301,140,6,37,1661,48,31,31,0,0,0,0,17,8,2,0,2,7,1613,504,423,81,27,54,0,1109,554,172,69,103,383,0,460301
14000US06037460302,140,6,37,1392,114,89,8,81,0,81,0,25,0,9,0,9,16,1278,577,339,227,92,135,11,701,281,135,63,72,285,0,460302
14000US06037460401,140,6,37,333,5,0,0,0,0,0,0,5,0,5,0,5,0,328,153,110,43,22,21,0,175,91,28,7,21,56,0,460401
14000US06037460501,140,6,37,1861,11,0,0,0,0,0,0,11,0,11,11,0,0,1850,789,704,85,43,42,0,1061,664,108,18,90,289,0,460501
14000US06037460502,140,6,37,1411,17,8,8,0,0,0,0,9,0,9,0,9,0,1394,621,541,80,11,69,0,773,522,78,31,47,173,0,460502
14000US06037460600,140,6,37,1467,23,0,0,0,0,0,0,23,23,0,0,0,0,1444,669,581,88,9,79,0,775,584,43,8,35,148,0,460600
14000US06037460700,140,6,37,1574,11,0,0,0,0,0,0,11,11,0,0,0,0,1563,726,636,90,45,45,0,837,681,22,0,22,134,0,460700
14000US06037460800,140,6,37,1291,0,0,0,0,0,0,0,0,0,0,0,0,0,1291,326,300,26,0,26,0,965,673,0,0,0,292,0,460800
14000US06037460900,140,6,37,1937,156,143,39,104,0,104,0,13,0,13,0,13,0,1781,584,383,193,22,171,8,1197,356,330,82,248,511,0,460900
14000US06037461000,140,6,37,1683,152,152,64,88,43,45,0,0,0,0,0,0,0,1531,629,464,153,0,153,12,902,246,211,92,119,445,0,461000
14000US06037461100,140,6,37,1668,110,102,0,102,11,91,0,8,0,8,0,8,0,1558,584,376,208,88,120,0,974,420,100,53,47,454,0,461100
14000US06037461200,140,6,37,1729,16,0,0,0,0,0,0,16,16,0,0,0,0,1713,609,531,78,0,78,0,1104,438,116,16,100,550,0,461200
14000US06037461300,140,6,37,2555,177,98,98,0,0,0,0,79,13,47,15,32,19,2378,662,632,30,0,30,0,1716,925,130,79,51,661,0,461300
14000US06037461400,140,6,37,1278,44,31,17,14,0,14,0,13,0,0,0,0,13,1234,341,274,67,13,54,0,893,318,84,0,84,491,0,461400
14000US06037461501,140,6,37,1287,114,64,8,56,0,56,0,50,0,18,0,18,32,1173,346,266,80,26,54,0,827,251,134,81,53,442,0,461501
14000US06037461502,140,6,37,1660,222,174,121,53,0,53,0,48,0,12,0,12,36,1438,682,420,247,90,157,15,756,246,106,13,93,404,0,461502
14000US06037461600,140,6,37,1625,178,178,39,139,0,139,0,0,0,0,0,0,0,1447,426,216,182,20,162,28,1021,334,222,31,191,465,0,461600
14000US06037461700,140,6,37,681,17,0,0,0,0,0,0,17,0,0,0,0,17,664,92,81,11,11,0,0,572,122,77,41,36,373,0,461700
14000US06037461901,140,6,37,1663,167,137,23,114,32,82,0,30,0,16,0,16,14,1496,623,223,400,69,331,0,873,233,149,89,60,491,0,461901
14000US06037461902,140,6,37,960,105,0,0,0,0,0,0,105,0,0,0,0,105,855,99,0,99,44,55,0,756,108,0,0,0,648,0,461902
14000US06037462001,140,6,37,1206,123,114,38,76,36,40,0,9,0,0,0,0,9,1083,430,264,166,77,89,0,653,161,184,95,89,308,0,462001
14000US06037462002,140,6,37,1089,171,139,94,45,0,45,0,32,0,24,0,24,8,918,389,230,159,11,148,0,529,132,152,54,98,245,0,462002
14000US06037462100,140,6,37,1638,77,65,37,28,0,28,0,12,0,6,0,6,6,1561,531,363,168,56,112,0,1030,293,206,76,130,531,0,462100
14000US06037462201,140,6,37,1851,138,68,0,60,17,43,8,70,0,49,35,14,21,1713,125,125,0,0,0,0,1588,248,122,8,114,1218,0,462201
14000US06037462202,140,6,37,1444,85,65,21,44,0,44,0,20,0,0,0,0,20,1359,126,99,22,22,0,5,1233,324,33,0,33,876,0,462202
14000US06037462301,140,6,37,1912,359,192,105,87,0,87,0,167,0,93,83,10,74,1553,393,285,108,29,79,0,1160,283,225,97,128,652,0,462301
14000US06037462302,140,6,37,1327,40,18,0,18,0,18,0,22,9,0,0,0,13,1287,164,130,23,9,14,11,1123,172,135,39,96,816,0,462302
14000US06037462400,140,6,37,1658,96,79,56,23,7,16,0,17,6,0,0,0,11,1562,410,310,100,71,29,0,1152,465,122,36,86,565,0,462400
14000US06037462500,140,6,37,2209,100,100,38,62,0,62,0,0,0,0,0,0,0,2109,606,509,97,8,89,0,1503,742,180,5,175,581,0,462500
14000US06037462600,140,6,37,850,20,14,0,14,0,14,0,6,0,0,0,0,6,830,239,211,22,6,16,6,591,282,47,0,47,262,0,462600
14000US06037462700,140,6,37,2122,33,21,21,0,0,0,0,12,0,0,0,0,12,2089,425,236,158,12,146,31,1664,688,167,42,125,809,0,462700
14000US06037462800,140,6,37,1095,68,41,41,0,0,0,0,27,0,0,0,0,27,1027,271,218,53,6,47,0,756,197,90,8,82,469,0,462800
14000US06037462900,140,6,37,1405,23,0,0,0,0,0,0,23,0,8,0,8,15,1382,473,391,82,10,72,0,909,401,200,41,159,308,0,462900
14000US06037463000,140,6,37,935,3,0,0,0,0,0,0,3,0,3,0,3,0,932,245,241,4,1,3,0,687,349,42,11,31,296,0,463000
14000US06037463101,140,6,37,867,15,0,0,0,0,0,0,15,0,9,9,0,6,852,222,185,37,24,13,0,630,318,89,36,53,223,0,463101
14000US06037463102,140,6,37,1215,114,108,30,78,2,76,0,6,0,0,0,0,6,1101,335,266,69,26,43,0,766,434,115,49,66,217,0,463102
14000US06037463200,140,6,37,1389,82,46,0,46,0,46,0,36,0,0,0,0,36,1307,368,279,89,38,51,0,939,423,113,12,101,403,0,463200
14000US06037463300,140,6,37,881,10,6,6,0,0,0,0,4,0,4,0,4,0,871,251,222,29,0,29,0,620,282,63,32,31,275,0,463300
14000US06037463400,140,6,37,2572,85,73,73,0,0,0,0,12,0,12,0,12,0,2487,346,232,114,91,23,0,2141,631,95,18,77,1415,0,463400
14000US06037463500,140,6,37,2521,65,51,30,21,0,21,0,14,0,14,0,14,0,2456,359,294,65,0,65,0,2097,407,51,37,14,1639,0,463500
14000US06037463601,140,6,37,3460,0,0,0,0,0,0,0,0,0,0,0,0,0,3460,377,281,96,14,82,0,3083,566,122,42,80,2395,0,463601
14000US06037463602,140,6,37,3308,89,44,0,44,0,44,0,45,0,0,0,0,45,3219,371,335,36,25,11,0,2848,375,120,60,60,2353,0,463602
14000US06037463700,140,6,37,1262,4,4,4,0,0,0,0,0,0,0,0,0,0,1258,182,136,46,0,46,0,1076,330,64,30,34,682,0,463700
14000US06037463800,140,6,37,1639,7,0,0,0,0,0,0,7,0,0,0,0,7,1632,346,328,18,7,11,0,1286,610,82,50,32,594,0,463800
14000US06037463900,140,6,37,1708,0,0,0,0,0,0,0,0,0,0,0,0,0,1708,205,186,19,6,13,0,1503,557,24,0,24,922,0,463900
14000US06037464000,140,6,37,2681,17,0,0,0,0,0,0,17,0,0,0,0,17,2664,576,515,61,42,19,0,2088,740,120,59,61,1228,0,464000
14000US06037464100,140,6,37,2445,0,0,0,0,0,0,0,0,0,0,0,0,0,2445,951,841,110,26,84,0,1494,1025,73,0,73,396,0,464100
14000US06037464200,140,6,37,1970,0,0,0,0,0,0,0,0,0,0,0,0,0,1970,859,687,172,61,111,0,1111,733,92,24,68,286,0,464200
14000US06037480002,140,6,37,1139,19,19,19,0,0,0,0,0,0,0,0,0,0,1120,407,367,40,12,28,0,713,388,128,29,99,197,0,480002
14000US06037480011,140,6,37,1781,90,85,48,37,13,24,0,5,5,0,0,0,0,1691,627,504,123,75,48,0,1064,444,163,49,114,457,0,480011
14000US06037480012,140,6,37,1671,47,20,12,8,8,0,0,27,18,4,0,4,5,1624,683,590,93,25,68,0,941,419,114,60,54,408,0,480012
14000US06037480101,140,6,37,1237,20,20,20,0,0,0,0,0,0,0,0,0,0,1217,587,407,180,29,151,0,630,265,155,41,114,210,0,480101
14000US06037480102,140,6,37,1375,14,14,5,9,0,9,0,0,0,0,0,0,0,1361,524,469,55,21,34,0,837,498,110,46,64,229,0,480102
14000US06037480201,140,6,37,1310,9,9,0,9,0,9,0,0,0,0,0,0,0,1301,499,480,19,8,11,0,802,503,90,0,90,209,0,480201
14000US06037480202,140,6,37,915,7,7,0,7,0,7,0,0,0,0,0,0,0,908,330,323,7,0,7,0,578,289,113,7,106,176,0,480202
14000US06037480302,140,6,37,1681,48,34,34,0,0,0,0,14,14,0,0,0,0,1633,451,306,126,20,106,19,1182,503,74,26,48,605,0,480302
14000US06037480303,140,6,37,1481,55,45,45,0,0,0,0,10,0,10,0,10,0,1426,361,193,168,48,120,0,1065,392,196,92,104,477,0,480303
14000US06037480304,140,6,37,1706,138,101,68,33,18,15,0,37,0,24,0,24,13,1568,317,177,140,49,91,0,1251,435,226,83,143,590,0,480304
14000US06037480400,140,6,37,2240,101,59,41,18,0,18,0,42,0,23,0,23,19,2139,591,346,245,50,195,0,1548,452,153,44,109,943,0,480400
14000US06037480500,140,6,37,2120,55,20,0,20,0,20,0,35,16,0,0,0,19,2065,847,592,246,53,193,9,1218,574,57,13,44,587,0,480500
14000US06037480600,140,6,37,3228,41,10,0,10,0,10,0,31,0,0,0,0,31,3187,1042,757,256,87,169,29,2145,490,229,75,154,1426,0,480600
14000US06037480702,140,6,37,1709,9,9,9,0,0,0,0,0,0,0,0,0,0,1700,593,504,89,33,56,0,1107,552,130,44,86,425,0,480702
14000US06037480703,140,6,37,1243,0,0,0,0,0,0,0,0,0,0,0,0,0,1243,419,323,96,31,65,0,824,296,97,0,97,431,0,480703
14000US06037480704,140,6,37,1922,45,21,10,11,0,11,0,24,0,0,0,0,24,1877,664,411,253,122,131,0,1213,459,118,9,109,636,0,480704
14000US06037480802,140,6,37,1021,34,27,8,19,0,19,0,7,0,7,0,7,0,987,306,258,48,32,16,0,681,390,93,48,45,198,0,480802
14000US06037480803,140,6,37,1195,58,34,11,23,0,23,0,24,0,24,24,0,0,1137,373,247,126,42,84,0,764,279,122,46,76,363,0,480803
14000US06037480804,140,6,37,1971,68,62,26,36,28,8,0,6,0,0,0,0,6,1903,644,430,214,83,131,0,1259,415,326,120,206,518,0,480804
14000US06037480901,140,6,37,1529,62,48,48,0,0,0,0,14,0,0,0,0,14,1467,464,289,175,70,105,0,1003,355,233,106,127,415,0,480901
14000US06037480902,140,6,37,1401,60,60,48,12,7,5,0,0,0,0,0,0,0,1341,371,259,112,17,95,0,970,254,326,48,278,390,0,480902
14000US06037480903,140,6,37,991,50,41,11,30,20,10,0,9,5,0,0,0,4,941,215,132,83,53,30,0,726,305,205,78,127,216,0,480903
14000US06037481001,140,6,37,1363,107,63,45,18,0,18,0,44,0,24,0,24,20,1256,351,257,59,10,49,35,905,309,139,46,93,457,0,481001
14000US06037481002,140,6,37,2047,122,63,28,35,26,9,0,59,36,12,0,12,11,1925,649,320,329,112,217,0,1276,542,186,125,61,548,0,481002
14000US06037481101,140,6,37,1416,45,26,15,11,0,11,0,19,12,7,7,0,0,1371,370,269,101,49,52,0,1001,367,156,88,68,478,0,481101
14000US06037481102,140,6,37,1324,118,82,27,55,9,46,0,36,23,13,6,7,0,1206,290,146,144,34,110,0,916,280,138,69,69,498,0,481102
14000US06037481103,140,6,37,1452,83,37,8,22,0,22,7,46,31,15,0,15,0,1369,457,267,190,75,115,0,912,376,195,146,49,341,0,481103
14000US06037481201,140,6,37,1211,46,37,36,1,0,1,0,9,9,0,0,0,0,1165,336,247,89,0,89,0,829,327,195,69,126,307,0,481201
14000US06037481202,140,6,37,1764,124,115,78,37,0,37,0,9,0,0,0,0,9,1640,461,371,90,43,47,0,1179,534,171,78,93,474,0,481202
14000US06037481300,140,6,37,826,24,24,17,7,0,7,0,0,0,0,0,0,0,802,316,205,111,24,87,0,486,299,103,35,68,84,0,481300
14000US06037481401,140,6,37,1882,84,32,32,0,0,0,0,52,22,30,9,21,0,1798,644,438,206,36,170,0,1154,533,260,130,130,361,0,481401
14000US06037481402,140,6,37,2115,107,107,68,39,0,39,0,0,0,0,0,0,0,2008,529,383,146,77,69,0,1479,459,472,209,263,548,0,481402
14000US06037481500,140,6,37,1514,23,23,23,0,0,0,0,0,0,0,0,0,0,1491,353,283,70,13,57,0,1138,411,133,37,96,594,0,481500
14000US06037481603,140,6,37,1261,85,63,15,48,23,25,0,22,15,0,0,0,7,1176,300,210,90,11,79,0,876,405,192,32,160,279,0,481603
14000US06037481604,140,6,37,1284,51,25,18,7,0,7,0,26,9,8,0,8,9,1233,324,270,54,8,46,0,909,378,178,36,142,353,0,481604
14000US06037481605,140,6,37,1064,136,104,51,53,0,53,0,32,13,19,0,19,0,928,152,134,18,0,18,0,776,323,156,51,105,297,0,481605
14000US06037481606,140,6,37,1493,63,63,57,6,0,6,0,0,0,0,0,0,0,1430,493,389,104,24,80,0,937,383,118,54,64,436,0,481606
14000US06037481711,140,6,37,1342,172,51,15,36,17,19,0,121,27,51,51,0,43,1170,187,159,28,0,28,0,983,296,327,135,192,360,0,481711
14000US06037481712,140,6,37,1496,44,11,11,0,0,0,0,33,26,0,0,0,7,1452,480,325,155,18,137,0,972,329,272,43,229,371,0,481712
14000US06037481713,140,6,37,753,35,3,3,0,0,0,0,32,19,0,0,0,13,718,233,142,76,37,39,15,485,199,131,56,75,155,0,481713
14000US06037481714,140,6,37,845,55,27,13,14,0,14,0,28,4,5,0,5,19,790,169,121,48,32,16,0,621,196,193,64,129,232,0,481714
14000US06037481800,140,6,37,919,30,6,6,0,0,0,0,24,17,7,0,7,0,889,272,191,74,29,45,7,617,303,72,13,59,242,0,481800
14000US06037481901,140,6,37,2006,36,21,15,6,0,6,0,15,6,0,0,0,9,1970,609,442,167,37,130,0,1361,665,228,73,155,468,0,481901
14000US06037481902,140,6,37,1192,67,21,4,17,0,17,0,46,17,29,0,29,0,1125,395,241,154,16,138,0,730,325,101,32,69,304,0,481902
14000US06037482001,140,6,37,996,17,0,0,0,0,0,0,17,9,8,8,0,0,979,247,210,37,16,21,0,732,402,96,20,76,234,0,482001
14000US06037482002,140,6,37,2244,130,106,14,92,0,92,0,24,0,13,13,0,11,2114,845,681,155,16,139,9,1269,559,268,97,171,442,0,482002
14000US06037482101,140,6,37,1401,107,107,37,70,15,55,0,0,0,0,0,0,0,1294,379,306,65,9,56,8,915,306,295,77,218,314,0,482101
14000US06037482102,140,6,37,915,10,0,0,0,0,0,0,10,5,0,0,0,5,905,349,199,150,69,81,0,556,275,131,25,106,150,0,482102
14000US06037482201,140,6,37,1219,106,54,48,6,0,6,0,52,29,6,0,6,17,1113,347,265,82,21,61,0,766,265,213,66,147,288,0,482201
14000US06037482202,140,6,37,1505,52,30,9,21,0,21,0,22,22,0,0,0,0,1453,571,480,91,39,52,0,882,394,198,55,143,290,0,482202
14000US06037482301,140,6,37,1337,84,57,40,17,0,17,0,27,0,27,27,0,0,1253,526,359,167,81,86,0,727,359,171,124,47,197,0,482301
14000US06037482303,140,6,37,1611,133,118,96,22,0,22,0,15,15,0,0,0,0,1478,637,430,207,73,134,0,841,319,291,131,160,231,0,482303
14000US06037482304,140,6,37,913,128,97,52,45,8,37,0,31,6,15,0,15,10,785,313,237,76,19,57,0,472,265,104,48,56,103,0,482304
14000US06037482401,140,6,37,947,102,61,34,27,2,25,0,41,33,8,0,8,0,845,375,240,135,69,66,0,470,298,123,74,49,49,0,482401
14000US06037482402,140,6,37,2152,230,203,49,154,9,145,0,27,14,13,0,13,0,1922,570,312,221,148,73,37,1352,607,377,107,270,368,0,482402
14000US06037482502,140,6,37,791,44,39,22,17,0,17,0,5,5,0,0,0,0,747,253,201,52,27,25,0,494,237,84,34,50,173,0,482502
14000US06037482503,140,6,37,1065,192,151,139,12,0,12,0,41,41,0,0,0,0,873,402,294,108,25,83,0,471,194,143,97,46,134,0,482503
14000US06037482521,140,6,37,1424,72,39,11,28,0,28,0,33,6,18,18,0,9,1352,590,377,213,58,155,0,762,369,198,79,119,195,0,482521
14000US06037482522,140,6,37,1481,58,51,29,22,0,22,0,7,0,0,0,0,7,1423,322,213,109,21,88,0,1101,436,270,75,195,395,0,482522
14000US06037482600,140,6,37,2186,24,0,0,0,0,0,0,24,0,24,13,11,0,2162,606,548,58,0,58,0,1556,890,256,71,185,410,0,482600
14000US06037482701,140,6,37,1344,28,18,0,18,0,18,0,10,0,6,0,6,4,1316,471,341,130,59,71,0,845,319,296,87,209,230,0,482701
14000US06037482702,140,6,37,768,0,0,0,0,0,0,0,0,0,0,0,0,0,768,243,160,83,24,59,0,525,312,54,21,33,159,0,482702
14000US06037482800,140,6,37,1249,91,47,11,36,9,27,0,44,10,34,0,34,0,1158,301,227,74,18,56,0,857,530,200,98,102,127,0,482800
14000US06037500100,140,6,37,1067,23,23,0,23,23,0,0,0,0,0,0,0,0,1044,294,247,47,23,24,0,750,514,46,13,33,190,0,500100
14000US06037500201,140,6,37,1917,62,13,13,0,0,0,0,49,49,0,0,0,0,1855,760,676,84,11,73,0,1095,610,97,10,87,388,0,500201
14000US06037500202,140,6,37,1459,6,6,6,0,0,0,0,0,0,0,0,0,0,1453,569,503,66,56,10,0,884,530,135,54,81,219,0,500202
14000US06037500300,140,6,37,1101,54,54,41,13,13,0,0,0,0,0,0,0,0,1047,353,236,108,47,61,9,694,279,34,21,13,381,0,500300
14000US06037500402,140,6,37,1142,64,44,7,37,0,37,0,20,9,0,0,0,11,1078,547,374,173,64,109,0,531,154,113,17,96,264,0,500402
14000US06037500403,140,6,37,1073,76,52,36,16,0,16,0,24,0,19,0,19,5,997,473,346,110,0,110,17,524,112,277,22,255,135,0,500403
14000US06037500404,140,6,37,1247,80,45,38,7,0,7,0,35,9,26,10,16,0,1167,528,392,136,69,67,0,639,270,164,31,133,205,0,500404
14000US06037500500,140,6,37,887,61,44,15,29,0,29,0,17,5,0,0,0,12,826,298,214,84,37,47,0,528,205,161,55,106,162,0,500500
14000US06037500600,140,6,37,1450,229,179,78,101,0,101,0,50,16,34,25,9,0,1221,476,341,135,60,75,0,745,284,197,103,94,264,0,500600
14000US06037500700,140,6,37,1686,151,90,39,51,6,45,0,61,26,26,0,26,9,1535,726,519,207,80,127,0,809,407,179,90,89,223,0,500700
14000US06037500800,140,6,37,1418,86,77,13,64,37,27,0,9,0,9,0,9,0,1332,653,437,216,42,174,0,679,252,101,56,45,326,0,500800
14000US06037500900,140,6,37,1541,136,94,5,89,27,62,0,42,25,9,0,9,8,1405,459,296,163,76,87,0,946,427,146,63,83,373,0,500900
14000US06037501001,140,6,37,651,57,42,0,42,0,42,0,15,0,15,0,15,0,594,376,291,85,15,70,0,218,94,69,5,64,55,0,501001
14000US06037501002,140,6,37,1386,115,98,62,36,0,36,0,17,17,0,0,0,0,1271,559,403,156,67,89,0,712,353,92,57,35,267,0,501002
14000US06037501200,140,6,37,1519,69,45,14,31,0,31,0,24,0,24,0,24,0,1450,596,462,134,41,93,0,854,226,313,77,236,315,0,501200
14000US06037501300,140,6,37,2314,86,86,20,66,0,66,0,0,0,0,0,0,0,2228,940,566,359,211,148,15,1288,560,205,44,161,523,0,501300
14000US06037501400,140,6,37,1133,114,85,23,62,11,51,0,29,0,29,7,22,0,1019,462,212,250,65,185,0,557,185,112,59,53,260,0,501400
14000US06037501501,140,6,37,819,14,14,7,7,0,7,0,0,0,0,0,0,0,805,233,171,62,29,33,0,572,275,80,26,54,217,0,501501
14000US06037501503,140,6,37,1890,130,114,17,97,0,97,0,16,0,9,9,0,7,1760,520,221,272,56,216,27,1240,391,170,80,90,679,0,501503
14000US06037501504,140,6,37,1558,264,164,75,69,11,58,20,100,0,20,0,20,80,1294,283,121,162,40,122,0,1011,240,105,13,92,666,0,501504
14000US06037501600,140,6,37,2249,104,93,50,43,28,15,0,11,0,11,0,11,0,2145,724,643,81,15,66,0,1421,539,195,97,98,687,0,501600
14000US06037501700,140,6,37,1247,44,44,38,6,0,6,0,0,0,0,0,0,0,1203,553,432,121,63,58,0,650,284,120,50,70,246,0,501700
14000US06037501802,140,6,37,1263,50,50,19,31,0,31,0,0,0,0,0,0,0,1213,460,359,101,9,92,0,753,286,70,5,65,397,0,501802
14000US06037501803,140,6,37,1446,264,242,84,136,11,125,22,22,12,0,0,0,10,1182,532,206,326,54,272,0,650,102,197,111,86,351,0,501803
14000US06037501804,140,6,37,751,79,48,0,48,13,35,0,31,0,7,0,7,24,672,210,137,73,21,52,0,462,103,66,13,53,293,0,501804
14000US06037501900,140,6,37,1331,23,23,18,5,0,5,0,0,0,0,0,0,0,1308,450,335,115,74,41,0,858,450,116,12,104,292,0,501900
14000US06037502003,140,6,37,780,108,103,27,76,51,25,0,5,0,5,0,5,0,672,348,267,81,19,62,0,324,102,42,10,32,180,0,502003
14000US06037502004,140,6,37,913,87,76,29,47,0,47,0,11,2,9,5,4,0,826,437,260,177,102,75,0,389,194,102,9,93,93,0,502004
14000US06037502005,140,6,37,1263,15,15,0,15,6,9,0,0,0,0,0,0,0,1248,667,480,175,121,54,12,581,268,61,6,55,252,0,502005
14000US06037502100,140,6,37,1610,57,57,50,7,0,7,0,0,0,0,0,0,0,1553,492,268,224,94,130,0,1061,331,170,33,137,560,0,502100
14000US06037502200,140,6,37,1728,188,113,70,43,27,16,0,75,42,33,11,22,0,1540,571,394,177,69,108,0,969,398,199,47,152,372,0,502200
14000US06037502301,140,6,37,1317,163,163,93,70,70,0,0,0,0,0,0,0,0,1154,582,392,190,68,122,0,572,329,146,24,122,97,0,502301
14000US06037502302,140,6,37,677,153,144,60,84,14,70,0,9,0,5,0,5,4,524,221,119,102,0,102,0,303,122,68,16,52,113,0,502302
14000US06037502401,140,6,37,1308,50,50,50,0,0,0,0,0,0,0,0,0,0,1258,499,360,139,92,47,0,759,318,157,71,86,284,0,502401
14000US06037502402,140,6,37,909,49,49,19,30,5,25,0,0,0,0,0,0,0,860,394,269,125,40,85,0,466,275,65,19,46,126,0,502402
14000US06037502500,140,6,37,1105,66,40,12,28,0,28,0,26,6,11,0,11,9,1039,475,269,206,115,91,0,564,294,76,54,22,194,0,502500
14000US06037502601,140,6,37,1850,168,132,122,10,0,10,0,36,6,19,8,11,11,1682,788,655,124,51,73,9,894,369,159,54,105,366,0,502601
14000US06037502602,140,6,37,1347,43,6,0,6,0,6,0,37,6,31,6,25,0,1304,520,296,224,55,169,0,784,300,110,46,64,374,0,502602
14000US06037502700,140,6,37,1800,148,101,57,44,6,38,0,47,11,12,12,0,24,1652,721,431,290,53,237,0,931,425,199,56,143,307,0,502700
14000US06037502801,140,6,37,1670,49,29,13,16,8,8,0,20,0,10,0,10,10,1621,742,565,166,59,107,11,879,470,216,86,130,193,0,502801
14000US06037502802,140,6,37,887,74,24,0,24,13,11,0,50,0,0,0,0,50,813,250,120,125,0,125,5,563,125,32,14,18,406,0,502802
14000US06037502901,140,6,37,1354,82,82,50,32,15,17,0,0,0,0,0,0,0,1272,552,442,110,14,96,0,720,340,160,64,96,220,0,502901
14000US06037502902,140,6,37,905,181,160,70,90,3,87,0,21,0,10,0,10,11,724,324,249,75,21,54,0,400,165,143,37,106,92,0,502902
14000US06037503000,140,6,37,1301,253,246,71,175,36,139,0,7,7,0,0,0,0,1048,576,366,210,15,195,0,472,197,114,42,72,161,0,503000
14000US06037503103,140,6,37,1063,80,80,44,36,14,22,0,0,0,0,0,0,0,983,576,377,199,135,64,0,407,155,80,11,69,172,0,503103
14000US06037503104,140,6,37,607,105,98,65,33,0,33,0,7,7,0,0,0,0,502,259,183,76,28,48,0,243,120,85,22,63,38,0,503104
14000US06037503105,140,6,37,992,123,102,18,84,41,43,0,21,10,11,5,6,0,869,483,274,209,140,69,0,386,220,47,5,42,119,0,503105
14000US06037503106,140,6,37,1047,46,30,15,15,0,15,0,16,0,0,0,0,16,1001,455,353,102,70,32,0,546,176,155,74,81,215,0,503106
14000US06037503201,140,6,37,1133,98,57,57,0,0,0,0,41,32,0,0,0,9,1035,398,285,113,16,97,0,637,420,91,16,75,126,0,503201
14000US06037503202,140,6,37,1312,147,126,61,65,0,65,0,21,21,0,0,0,0,1165,411,299,112,44,68,0,754,261,291,150,141,202,0,503202
14000US06037503301,140,6,37,1052,14,14,0,14,14,0,0,0,0,0,0,0,0,1038,322,244,78,18,60,0,716,315,127,56,71,274,0,503301
14000US06037503302,140,6,37,1897,108,108,64,44,9,35,0,0,0,0,0,0,0,1789,862,496,356,30,326,10,927,476,228,64,164,223,0,503302
14000US06037503401,140,6,37,2260,0,0,0,0,0,0,0,0,0,0,0,0,0,2260,999,623,376,170,206,0,1261,590,175,43,132,496,0,503401
14000US06037503402,140,6,37,1412,32,10,10,0,0,0,0,22,10,12,0,12,0,1380,528,476,52,25,27,0,852,375,170,81,89,307,0,503402
14000US06037503501,140,6,37,1956,86,65,32,33,7,26,0,21,11,10,10,0,0,1870,868,589,256,42,214,23,1002,435,106,40,66,461,0,503501
14000US06037503502,140,6,37,1252,62,38,11,27,0,27,0,24,0,24,0,24,0,1190,544,395,139,70,69,10,646,288,102,49,53,256,0,503502
14000US06037503601,140,6,37,1211,5,0,0,0,0,0,0,5,0,5,0,5,0,1206,476,316,150,131,19,10,730,433,101,29,72,196,0,503601
14000US06037503602,140,6,37,1206,20,20,20,0,0,0,0,0,0,0,0,0,0,1186,341,287,54,12,42,0,845,583,66,14,52,196,0,503602
14000US06037503701,140,6,37,1707,25,9,0,9,0,9,0,16,9,0,0,0,7,1682,743,482,261,117,144,0,939,386,79,59,20,474,0,503701
14000US06037503702,140,6,37,1621,66,43,19,24,6,18,0,23,19,0,0,0,4,1555,664,509,155,63,92,0,891,401,110,25,85,380,0,503702
14000US06037503703,140,6,37,2925,62,4,0,4,4,0,0,58,58,0,0,0,0,2863,764,618,146,34,112,0,2099,1184,107,61,46,808,0,503703
14000US06037503801,140,6,37,1225,57,57,18,39,30,9,0,0,0,0,0,0,0,1168,447,318,129,22,107,0,721,498,95,31,64,128,0,503801
14000US06037503802,140,6,37,1473,93,79,0,79,13,66,0,14,0,14,4,10,0,1380,564,469,95,10,85,0,816,447,69,47,22,300,0,503802
14000US06037503901,140,6,37,807,45,23,23,0,0,0,0,22,16,6,6,0,0,762,315,231,84,18,66,0,447,243,78,17,61,126,0,503901
14000US06037503902,140,6,37,1360,55,45,35,10,0,10,0,10,0,10,0,10,0,1305,525,482,43,0,43,0,780,445,123,63,60,212,0,503902
14000US06037504001,140,6,37,1054,26,10,10,0,0,0,0,16,0,9,0,9,7,1028,321,265,56,39,17,0,707,422,31,28,3,254,0,504001
14000US06037504002,140,6,37,1577,17,17,11,6,0,6,0,0,0,0,0,0,0,1560,582,499,83,36,47,0,978,453,248,79,169,277,0,504002
14000US06037504101,140,6,37,1375,127,89,42,47,0,47,0,38,30,8,0,8,0,1248,470,277,193,32,161,0,778,396,92,7,85,290,0,504101
14000US06037504102,140,6,37,0,0,0,0,0,0,0,0,0,0,0,0,0,0,0,0,0,0,0,0,0,0,0,0,0,0,0,0,504102
14000US06037530003,140,6,37,921,40,40,18,22,8,14,0,0,0,0,0,0,0,881,302,195,107,27,80,0,579,401,46,6,40,132,0,530003
14000US06037530004,140,6,37,1217,57,37,11,17,0,17,9,20,0,20,0,20,0,1160,342,229,113,24,89,0,818,333,240,59,181,245,0,530004
14000US06037530005,140,6,37,1553,18,10,10,0,0,0,0,8,0,8,0,8,0,1535,393,270,123,0,123,0,1142,686,148,76,72,308,0,530005
14000US06037530006,140,6,37,1363,109,60,10,50,27,23,0,49,0,49,0,49,0,1254,410,261,149,19,130,0,844,304,201,24,177,339,0,530006
14000US06037530101,140,6,37,1751,292,252,69,183,35,148,0,40,0,0,0,0,40,1459,492,324,168,46,122,0,967,408,146,44,102,413,0,530101
14000US06037530102,140,6,37,1709,68,64,16,48,8,40,0,4,0,4,0,4,0,1641,416,272,129,19,110,15,1225,367,160,83,77,698,0,530102
14000US06037530202,140,6,37,1274,38,31,0,31,0,31,0,7,0,7,0,7,0,1236,409,208,201,56,145,0,827,319,244,82,162,264,0,530202
14000US06037530203,140,6,37,973,46,46,0,46,10,36,0,0,0,0,0,0,0,927,358,189,159,92,67,10,569,213,96,18,78,260,0,530203
14000US06037530204,140,6,37,1075,119,97,25,72,13,59,0,22,0,22,0,22,0,956,408,218,190,51,139,0,548,267,135,32,103,146,0,530204
14000US06037530301,140,6,37,563,48,44,13,31,21,10,0,4,0,4,0,4,0,515,227,119,80,13,67,28,288,115,66,38,28,107,0,530301
14000US06037530302,140,6,37,1860,133,95,28,67,33,34,0,38,10,14,14,0,14,1727,797,504,293,69,224,0,930,314,302,98,204,314,0,530302
14000US06037530400,140,6,37,1224,137,129,41,88,0,88,0,8,0,0,0,0,8,1087,342,220,122,16,106,0,745,182,201,9,192,362,0,530400
14000US06037530500,140,6,37,1227,239,127,73,54,10,44,0,112,11,56,7,49,45,988,420,289,131,31,100,0,568,190,144,57,87,234,0,530500
14000US06037530601,140,6,37,878,160,155,69,86,19,67,0,5,5,0,0,0,0,718,428,206,179,60,119,43,290,112,54,27,27,124,0,530601
14000US06037530602,140,6,37,404,18,7,4,3,3,0,0,11,0,11,0,11,0,386,171,85,77,26,51,9,215,51,55,6,49,109,0,530602
14000US06037530700,140,6,37,483,85,59,17,42,14,28,0,26,10,9,5,4,7,398,198,129,69,32,37,0,200,96,37,25,12,67,0,530700
14000US06037530801,140,6,37,1485,153,130,23,107,62,45,0,23,23,0,0,0,0,1332,653,378,275,93,182,0,679,193,209,82,127,277,0,530801
14000US06037530802,140,6,37,856,199,177,77,100,15,85,0,22,0,5,0,5,17,657,256,196,60,32,28,0,401,129,147,78,69,125,0,530802
14000US06037530901,140,6,37,931,157,143,92,51,27,24,0,14,0,0,0,0,14,774,417,304,113,50,63,0,357,75,86,34,52,196,0,530901
14000US06037530902,140,6,37,1183,146,127,39,69,0,69,19,19,0,19,10,9,0,1037,446,264,182,38,144,0,591,98,124,43,81,369,0,530902
14000US06037531000,140,6,37,1291,148,102,36,66,8,58,0,46,28,10,10,0,8,1143,496,386,110,56,54,0,647,176,180,80,100,291,0,531000
14000US06037531101,140,6,37,1252,141,118,85,33,7,26,0,23,0,0,0,0,23,1111,441,272,169,45,124,0,670,173,213,109,104,284,0,531101
14000US06037531102,140,6,37,885,137,133,42,91,24,67,0,4,0,0,0,0,4,748,194,119,75,37,38,0,554,136,87,24,63,331,0,531102
14000US06037531201,140,6,37,1257,208,181,138,20,5,15,23,27,0,0,0,0,27,1049,514,334,180,35,145,0,535,199,154,41,113,182,0,531201
14000US06037531202,140,6,37,1086,171,142,109,33,28,5,0,29,0,6,0,6,23,915,503,242,261,85,176,0,412,155,118,40,78,139,0,531202
14000US06037531301,140,6,37,1291,149,133,24,99,41,58,10,16,0,10,0,10,6,1142,757,508,240,102,138,9,385,119,65,38,27,201,0,531301
14000US06037531302,140,6,37,1526,162,139,44,95,35,60,0,23,8,10,0,10,5,1364,822,462,338,157,181,22,542,316,98,67,31,128,0,531302
14000US06037531502,140,6,37,801,180,128,71,57,23,34,0,52,17,35,0,35,0,621,336,185,151,40,111,0,285,78,58,35,23,149,0,531502
14000US06037531503,140,6,37,764,173,154,57,97,0,97,0,19,14,5,5,0,0,591,328,262,66,12,54,0,263,145,45,38,7,73,0,531503
14000US06037531504,140,6,37,1118,218,159,65,94,37,57,0,59,6,43,12,31,10,900,461,249,212,20,192,0,439,186,80,22,58,173,0,531504
14000US06037531602,140,6,37,1168,270,199,119,80,15,65,0,71,34,26,0,26,11,898,425,209,216,57,159,0,473,174,124,68,56,175,0,531602
14000US06037531603,140,6,37,847,150,125,79,46,14,32,0,25,0,25,11,14,0,697,363,279,84,34,50,0,334,75,117,64,53,142,0,531603
14000US06037531604,140,6,37,877,135,129,51,78,0,78,0,6,0,6,6,0,0,742,371,212,159,87,72,0,371,83,113,28,85,175,0,531604
14000US06037531701,140,6,37,1295,130,130,55,55,16,39,20,0,0,0,0,0,0,1165,585,407,178,102,76,0,580,273,141,51,90,166,0,531701
14000US06037531702,140,6,37,1276,164,87,61,26,0,26,0,77,15,30,11,19,32,1112,482,302,180,32,148,0,630,175,187,66,121,268,0,531702
14000US06037531800,140,6,37,1172,128,115,47,68,0,68,0,13,0,0,0,0,13,1044,535,313,222,8,214,0,509,159,188,70,118,162,0,531800
14000US06037531901,140,6,37,1729,142,104,32,72,0,72,0,38,11,27,11,16,0,1587,920,601,309,40,269,10,667,236,130,11,119,301,0,531901
14000US06037531902,140,6,37,1121,78,71,30,41,12,29,0,7,0,7,0,7,0,1043,461,209,252,114,138,0,582,213,194,67,127,175,0,531902
14000US06037532001,140,6,37,1145,105,46,22,24,24,0,0,59,0,17,0,17,42,1040,363,229,134,38,96,0,677,221,99,7,92,357,0,532001
14000US06037532002,140,6,37,875,117,98,37,61,26,35,0,19,0,0,0,0,19,758,284,181,103,24,79,0,474,77,110,53,57,287,0,532002
14000US06037532101,140,6,37,1740,293,235,68,167,30,137,0,58,0,58,6,52,0,1447,770,416,354,125,229,0,677,287,123,48,75,267,0,532101
14000US06037532102,140,6,37,1012,86,63,51,12,0,12,0,23,0,0,0,0,23,926,239,203,36,6,30,0,687,260,173,27,146,254,0,532102
14000US06037532200,140,6,37,1812,372,316,31,285,46,239,0,56,0,3,0,3,53,1440,560,348,212,69,143,0,880,281,185,56,129,414,0,532200
14000US06037532302,140,6,37,1086,92,73,28,45,8,37,0,19,8,11,0,11,0,994,527,363,164,104,60,0,467,223,139,46,93,105,0,532302
14000US06037532303,140,6,37,1253,239,185,108,77,30,47,0,54,15,31,0,31,8,1014,292,214,78,28,50,0,722,328,84,32,52,310,0,532303
14000US06037532304,140,6,37,1031,180,143,66,61,24,37,16,37,0,0,0,0,37,851,443,327,116,34,82,0,408,145,42,20,22,221,0,532304
14000US06037532400,140,6,37,21,0,0,0,0,0,0,0,0,0,0,0,0,0,21,4,4,0,0,0,0,17,7,0,0,0,10,0,532400
14000US06037532500,140,6,37,1071,237,205,75,130,21,109,0,32,0,32,16,16,0,834,283,146,129,50,79,8,551,221,173,81,92,157,0,532500
14000US06037532603,140,6,37,751,227,211,133,78,42,36,0,16,0,7,4,3,9,524,338,207,131,13,118,0,186,53,73,23,50,60,0,532603
14000US06037532604,140,6,37,651,119,116,67,49,0,49,0,3,3,0,0,0,0,532,347,229,118,32,86,0,185,62,55,5,50,68,0,532604
14000US06037532605,140,6,37,1112,150,135,57,78,26,52,0,15,0,0,0,0,15,962,530,243,287,125,162,0,432,86,110,47,63,236,0,532605
14000US06037532606,140,6,37,1208,311,264,116,148,27,121,0,47,0,16,0,16,31,897,340,194,146,36,110,0,557,137,107,16,91,313,0,532606
14000US06037532700,140,6,37,622,214,209,76,133,51,82,0,5,0,0,0,0,5,408,179,85,83,39,44,11,229,99,79,32,47,51,0,532700
14000US06037532800,140,6,37,885,282,258,123,135,11,124,0,24,5,10,0,10,9,603,396,250,146,64,82,0,207,57,61,27,34,89,0,532800
14000US06037532900,140,6,37,1531,483,399,146,253,47,206,0,84,0,59,0,59,25,1048,603,354,249,99,150,0,445,109,158,74,84,178,0,532900
14000US06037533001,140,6,37,974,261,206,20,186,66,120,0,55,12,43,0,43,0,713,396,202,194,64,130,0,317,103,78,40,38,136,0,533001
14000US06037533002,140,6,37,642,98,90,35,55,8,47,0,8,4,4,4,0,0,544,280,141,139,72,67,0,264,110,105,47,58,49,0,533002
14000US06037533103,140,6,37,812,206,206,95,106,39,67,5,0,0,0,0,0,0,606,304,189,115,44,71,0,302,88,86,40,46,128,0,533103
14000US06037533104,140,6,37,1279,351,316,69,240,87,153,7,35,0,18,0,18,17,928,354,225,129,39,90,0,574,175,163,72,91,236,0,533104
14000US06037533105,140,6,37,623,138,116,75,41,0,41,0,22,7,4,4,0,11,485,257,154,103,41,62,0,228,60,81,21,60,87,0,533105
14000US06037533106,140,6,37,396,107,107,85,22,0,22,0,0,0,0,0,0,0,289,152,77,75,12,63,0,137,94,18,4,14,25,0,533106
14000US06037533107,140,6,37,959,238,206,62,144,35,109,0,32,8,7,0,7,17,721,377,198,179,53,126,0,344,175,87,20,67,82,0,533107
14000US06037533201,140,6,37,676,127,113,41,72,22,50,0,14,7,7,0,7,0,549,227,132,84,18,66,11,322,140,95,50,45,87,0,533201
14000US06037533202,140,6,37,624,145,145,87,58,26,32,0,0,0,0,0,0,0,479,205,131,74,9,65,0,274,146,84,4,80,44,0,533202
14000US06037533203,140,6,37,375,88,85,44,41,0,41,0,3,0,0,0,0,3,287,117,65,52,28,24,0,170,71,40,8,32,59,0,533203
14000US06037533300,140,6,37,794,156,156,86,70,12,58,0,0,0,0,0,0,0,638,312,177,135,56,79,0,326,119,124,100,24,83,0,533300
14000US06037533401,140,6,37,1099,165,165,52,113,8,105,0,0,0,0,0,0,0,934,569,398,171,93,78,0,365,151,151,75,76,63,0,533401
14000US06037533402,140,6,37,976,117,111,47,64,7,57,0,6,0,0,0,0,6,859,561,317,244,111,133,0,298,112,71,30,41,115,0,533402
14000US06037533403,140,6,37,700,135,104,26,78,14,64,0,31,6,16,5,11,9,565,280,148,121,46,75,11,285,114,26,6,20,145,0,533403
14000US06037533501,140,6,37,730,227,227,109,113,53,60,5,0,0,0,0,0,0,503,281,201,80,12,68,0,222,63,140,105,35,19,0,533501
14000US06037533502,140,6,37,511,110,110,79,25,25,0,6,0,0,0,0,0,0,401,207,129,78,24,54,0,194,109,22,0,22,63,0,533502
14000US06037533503,140,6,37,442,43,34,14,20,11,9,0,9,0,9,0,9,0,399,230,117,113,48,65,0,169,59,57,42,15,53,0,533503
14000US06037533601,140,6,37,1142,105,96,49,47,13,34,0,9,9,0,0,0,0,1037,663,378,285,52,233,0,374,85,96,33,63,193,0,533601
14000US06037533602,140,6,37,1433,240,141,21,120,0,120,0,99,41,58,0,58,0,1193,527,321,206,35,171,0,666,355,111,50,61,200,0,533602
14000US06037533603,140,6,37,1710,194,186,54,121,29,92,11,8,0,0,0,0,8,1516,797,438,359,140,219,0,719,318,51,44,7,350,0,533603
14000US06037533701,140,6,37,934,129,129,59,70,9,61,0,0,0,0,0,0,0,805,447,262,185,78,107,0,358,176,42,20,22,140,0,533701
14000US06037533702,140,6,37,840,182,158,79,79,10,69,0,24,7,6,0,6,11,658,394,261,133,68,65,0,264,125,28,17,11,111,0,533702
14000US06037533703,140,6,37,970,190,177,77,100,9,91,0,13,0,0,0,0,13,780,405,255,150,36,114,0,375,183,87,20,67,105,0,533703
14000US06037533803,140,6,37,1616,233,192,47,145,37,108,0,41,0,19,19,0,22,1383,737,514,223,105,118,0,646,185,157,39,118,304,0,533803
14000US06037533804,140,6,37,1238,119,57,48,9,0,9,0,62,39,10,10,0,13,1119,538,339,199,41,158,0,581,287,78,38,40,216,0,533804
14000US06037533805,140,6,37,938,129,116,67,49,25,24,0,13,5,8,0,8,0,809,474,297,177,68,109,0,335,156,62,4,58,117,0,533805
14000US06037533806,140,6,37,1025,166,151,52,99,70,29,0,15,3,0,0,0,12,859,478,308,170,34,136,0,381,123,106,27,79,152,0,533806
14000US06037533901,140,6,37,1431,93,93,18,75,21,54,0,0,0,0,0,0,0,1338,752,534,218,48,170,0,586,250,89,18,71,247,0,533901
14000US06037533902,140,6,37,946,88,88,37,51,0,51,0,0,0,0,0,0,0,858,476,256,220,83,137,0,382,182,73,40,33,127,0,533902
14000US06037534001,140,6,37,1274,357,340,192,148,18,130,0,17,8,0,0,0,9,917,454,328,126,40,86,0,463,157,138,53,85,168,0,534001
14000US06037534002,140,6,37,1016,173,153,63,90,16,74,0,20,0,11,0,11,9,843,434,299,126,59,67,9,409,149,108,28,80,152,0,534002
14000US06037534101,140,6,37,497,73,69,7,62,0,62,0,4,0,0,0,0,4,424,280,247,33,27,6,0,144,98,38,23,15,8,0,534101
14000US06037534102,140,6,37,1493,295,295,168,127,8,119,0,0,0,0,0,0,0,1198,665,462,203,52,151,0,533,172,82,55,27,279,0,534102
14000US06037534201,140,6,37,1058,206,206,102,104,38,66,0,0,0,0,0,0,0,852,438,283,155,50,105,0,414,114,87,10,77,213,0,534201
14000US06037534202,140,6,37,1267,277,267,143,124,17,107,0,10,0,0,0,0,10,990,700,450,250,74,176,0,290,134,68,0,68,88,0,534202
14000US06037534203,140,6,37,826,97,97,41,56,27,29,0,0,0,0,0,0,0,729,392,238,154,70,84,0,337,102,97,10,87,138,0,534203
14000US06037534301,140,6,37,1124,308,292,56,236,66,170,0,16,0,8,0,8,8,816,459,301,158,29,129,0,357,148,76,37,39,133,0,534301
14000US06037534302,140,6,37,841,228,223,95,117,20,97,11,5,0,5,0,5,0,613,442,339,103,18,85,0,171,45,100,24,76,26,0,534302
14000US06037534403,140,6,37,725,86,63,28,35,0,35,0,23,17,0,0,0,6,639,369,186,183,75,108,0,270,94,94,29,65,82,0,534403
14000US06037534404,140,6,37,946,137,109,41,68,41,27,0,28,10,13,0,13,5,809,428,197,231,49,182,0,381,151,75,21,54,155,0,534404
14000US06037534405,140,6,37,927,164,128,46,82,0,82,0,36,27,9,0,9,0,763,384,272,98,46,52,14,379,223,89,0,89,67,0,534405
14000US06037534406,140,6,37,1029,208,183,79,104,14,90,0,25,0,2,0,2,23,821,529,283,246,50,196,0,292,136,44,33,11,112,0,534406
14000US06037534501,140,6,37,1203,211,211,41,170,47,123,0,0,0,0,0,0,0,992,473,273,200,65,135,0,519,145,226,90,136,148,0,534501
14000US06037534502,140,6,37,1032,232,150,127,23,0,23,0,82,2,7,7,0,73,800,414,303,111,0,111,0,386,199,98,11,87,89,0,534502
14000US06037534700,140,6,37,918,142,137,69,68,47,21,0,5,0,0,0,0,5,776,460,389,67,27,40,4,316,150,111,61,50,55,0,534700
14000US06037534802,140,6,37,634,97,86,42,44,4,40,0,11,0,0,0,0,11,537,335,156,179,45,134,0,202,81,56,36,20,65,0,534802
14000US06037534803,140,6,37,1127,202,127,33,94,26,68,0,75,43,32,10,22,0,925,460,285,175,59,116,0,465,202,68,8,60,195,0,534803
14000US06037534804,140,6,37,904,220,176,57,119,41,78,0,44,0,24,0,24,20,684,314,223,91,20,71,0,370,223,77,20,57,70,0,534804
14000US06037534900,140,6,37,1488,322,253,103,150,14,136,0,69,17,33,11,22,19,1166,718,482,216,82,134,20,448,156,145,71,74,147,0,534900
14000US06037535001,140,6,37,1003,280,245,72,173,106,67,0,35,3,22,0,22,10,723,401,243,158,81,77,0,322,98,84,27,57,140,0,535001
14000US06037535002,140,6,37,729,168,153,83,70,49,21,0,15,8,7,0,7,0,561,303,205,89,6,83,9,258,128,55,26,29,75,0,535002
14000US06037535101,140,6,37,1745,475,345,101,244,87,157,0,130,23,42,0,42,65,1270,676,391,285,118,167,0,594,218,174,47,127,202,0,535101
14000US06037535102,140,6,37,940,266,213,138,75,0,75,0,53,24,29,15,14,0,674,341,179,162,29,133,0,333,132,109,31,78,92,0,535102
14000US06037535200,140,6,37,1267,354,304,133,171,32,139,0,50,16,9,0,9,25,913,447,251,196,87,109,0,466,204,144,19,125,118,0,535200
14000US06037535300,140,6,37,1458,431,396,181,215,36,179,0,35,0,19,0,19,16,1027,508,299,206,68,138,3,519,181,143,33,110,195,0,535300
14000US06037535400,140,6,37,704,211,211,78,133,0,133,0,0,0,0,0,0,0,493,338,236,102,23,79,0,155,33,55,33,22,67,0,535400
14000US06037535501,140,6,37,995,135,135,62,73,29,44,0,0,0,0,0,0,0,860,490,311,179,73,106,0,370,201,47,13,34,122,0,535501
14000US06037535502,140,6,37,1178,162,95,16,79,32,47,0,67,5,32,14,18,30,1016,600,375,225,61,164,0,416,268,23,0,23,125,0,535502
14000US06037535503,140,6,37,597,176,161,62,99,11,88,0,15,0,15,0,15,0,421,164,119,45,23,22,0,257,118,49,0,49,90,0,535503
14000US06037535603,140,6,37,828,171,167,67,100,17,83,0,4,0,0,0,0,4,657,348,226,122,55,67,0,309,137,66,5,61,106,0,535603
14000US06037535604,140,6,37,1028,189,180,79,101,49,52,0,9,6,0,0,0,3,839,523,217,306,128,178,0,316,164,80,9,71,72,0,535604
14000US06037535605,140,6,37,1095,219,183,90,93,30,63,0,36,22,0,0,0,14,876,368,204,164,45,119,0,508,201,79,70,9,228,0,535605
14000US06037535606,140,6,37,492,96,96,43,43,4,39,10,0,0,0,0,0,0,396,231,157,74,35,39,0,165,40,54,54,0,71,0,535606
14000US06037535607,140,6,37,1006,123,99,7,92,0,92,0,24,0,0,0,0,24,883,451,349,102,42,60,0,432,246,158,54,104,28,0,535607
14000US06037535701,140,6,37,1512,366,254,143,111,42,69,0,112,71,22,0,22,19,1146,714,477,215,65,150,22,432,203,90,41,49,139,0,535701
14000US06037535702,140,6,37,1340,205,131,24,107,25,82,0,74,57,0,0,0,17,1135,510,220,267,39,228,23,625,265,139,50,89,221,0,535702
14000US06037535802,140,6,37,1724,211,196,56,140,37,103,0,15,9,0,0,0,6,1513,651,443,208,49,159,0,862,402,186,56,130,274,0,535802
14000US06037535803,140,6,37,1044,138,130,60,70,0,70,0,8,8,0,0,0,0,906,508,281,227,69,158,0,398,124,134,59,75,140,0,535803
14000US06037535804,140,6,37,1303,172,152,100,52,0,52,0,20,0,20,0,20,0,1131,568,424,144,46,98,0,563,152,103,28,75,308,0,535804
14000US06037535901,140,6,37,1426,140,114,97,17,0,17,0,26,0,19,0,19,7,1286,561,439,122,17,105,0,725,404,102,76,26,219,0,535901
14000US06037535902,140,6,37,1569,133,85,41,44,15,29,0,48,18,30,0,30,0,1436,767,602,165,77,88,0,669,321,198,83,115,150,0,535902
14000US06037536000,140,6,37,1005,142,124,41,83,12,71,0,18,0,7,0,7,11,863,360,194,161,47,114,5,503,214,154,56,98,135,0,536000
14000US06037536102,140,6,37,1036,46,46,27,19,10,9,0,0,0,0,0,0,0,990,324,215,109,0,109,0,666,235,86,22,64,345,0,536102
14000US06037536103,140,6,37,1503,143,118,58,60,33,27,0,25,0,25,0,25,0,1360,667,460,207,41,166,0,693,241,217,69,148,235,0,536103
14000US06037536104,140,6,37,1021,189,139,69,70,28,42,0,50,5,16,0,16,29,832,445,332,113,11,102,0,387,183,97,89,8,107,0,536104
14000US06037536200,140,6,37,1914,118,110,48,62,0,62,0,8,0,8,0,8,0,1796,992,622,370,71,299,0,804,366,157,98,59,281,0,536200
14000US06037540000,140,6,37,1519,229,205,83,115,12,103,7,24,14,0,0,0,10,1290,713,409,304,124,180,0,577,205,152,80,72,220,0,540000
14000US06037540101,140,6,37,1465,175,160,95,65,14,51,0,15,15,0,0,0,0,1290,717,465,232,66,166,20,573,253,142,33,109,178,0,540101
14000US06037540102,140,6,37,1566,178,168,78,66,0,66,24,10,0,10,0,10,0,1388,704,552,140,65,75,12,684,215,205,86,119,264,0,540102
14000US06037540201,140,6,37,573,82,69,6,63,13,50,0,13,4,0,0,0,9,491,284,143,141,49,92,0,207,37,69,26,43,101,0,540201
14000US06037540202,140,6,37,1689,494,494,120,374,54,320,0,0,0,0,0,0,0,1195,549,386,163,21,142,0,646,229,164,16,148,253,0,540202
14000US06037540203,140,6,37,1288,272,258,135,123,5,118,0,14,0,0,0,0,14,1016,554,324,230,57,173,0,462,119,178,81,97,165,0,540203
14000US06037540300,140,6,37,1155,327,274,171,103,24,79,0,53,11,16,0,16,26,828,527,390,137,43,94,0,301,210,48,11,37,43,0,540300
14000US06037540400,140,6,37,470,121,112,91,21,14,7,0,9,2,7,0,7,0,349,211,99,112,39,73,0,138,34,36,4,32,68,0,540400
14000US06037540501,140,6,37,1057,200,182,82,100,56,44,0,18,0,18,0,18,0,857,546,375,171,90,81,0,311,160,75,44,31,76,0,540501
14000US06037540502,140,6,37,1477,324,255,46,209,21,188,0,69,0,18,0,18,51,1153,835,565,270,33,237,0,318,27,91,53,38,200,0,540502
14000US06037540600,140,6,37,1043,199,157,16,141,0,141,0,42,0,42,9,33,0,844,346,227,119,25,94,0,498,70,70,9,61,358,0,540600
14000US06037540700,140,6,37,732,155,127,22,105,5,100,0,28,11,10,0,10,7,577,306,179,127,15,112,0,271,73,94,48,46,104,0,540700
14000US06037540800,140,6,37,1635,204,183,9,163,27,136,11,21,0,10,0,10,11,1431,704,329,375,55,320,0,727,146,244,18,226,337,0,540800
14000US06037540901,140,6,37,1137,191,165,91,74,0,74,0,26,0,26,0,26,0,946,362,297,65,6,59,0,584,248,92,21,71,244,0,540901
14000US06037540902,140,6,37,1431,174,135,35,100,0,100,0,39,0,0,0,0,39,1257,521,236,285,84,201,0,736,153,231,65,166,352,0,540902
14000US06037541001,140,6,37,302,21,12,0,12,7,5,0,9,9,0,0,0,0,281,119,50,69,0,69,0,162,59,33,11,22,70,0,541001
14000US06037541002,140,6,37,1049,41,30,21,9,0,9,0,11,0,0,0,0,11,1008,305,186,119,10,109,0,703,152,213,11,202,338,0,541002
14000US06037541100,140,6,37,864,130,109,22,87,19,68,0,21,5,16,7,9,0,734,335,105,230,71,159,0,399,90,77,0,77,232,0,541100
14000US06037541200,140,6,37,1825,246,167,70,97,0,97,0,79,22,48,6,42,9,1579,508,208,270,31,239,30,1071,377,286,138,148,408,0,541200
14000US06037541300,140,6,37,1483,231,196,38,154,0,154,4,35,0,19,11,8,16,1252,689,391,271,65,206,27,563,123,223,100,123,217,0,541300
14000US06037541400,140,6,37,1561,563,431,145,286,33,253,0,132,0,21,0,21,111,998,531,350,181,67,114,0,467,134,234,70,164,99,0,541400
14000US06037541500,140,6,37,1219,320,268,88,180,83,97,0,52,11,9,0,9,32,899,543,350,193,55,138,0,356,218,42,7,35,96,0,541500
14000US06037541603,140,6,37,634,246,224,69,155,59,96,0,22,17,0,0,0,5,388,233,143,90,35,55,0,155,55,46,6,40,54,0,541603
14000US06037541604,140,6,37,1417,294,255,130,125,26,99,0,39,20,10,0,10,9,1123,614,314,300,89,211,0,509,172,172,112,60,165,0,541604
14000US06037541605,140,6,37,1273,227,189,64,125,23,102,0,38,6,20,0,20,12,1046,473,275,198,73,125,0,573,194,219,98,121,160,0,541605
14000US06037541606,140,6,37,551,113,106,33,73,5,68,0,7,0,7,7,0,0,438,243,131,112,29,83,0,195,95,42,22,20,58,0,541606
14000US06037541700,140,6,37,1372,68,28,18,10,0,10,0,40,0,27,27,0,13,1304,717,395,322,51,271,0,587,249,159,39,120,179,0,541700
14000US06037541801,140,6,37,1096,132,120,94,26,4,22,0,12,0,12,12,0,0,964,527,328,199,51,148,0,437,172,123,48,75,142,0,541801
14000US06037541802,140,6,37,1148,166,166,65,101,19,82,0,0,0,0,0,0,0,982,520,392,128,68,60,0,462,171,101,54,47,190,0,541802
14000US06037542000,140,6,37,1150,367,336,140,196,65,131,0,31,6,25,19,6,0,783,382,283,99,58,41,0,401,136,181,68,113,84,0,542000
14000US06037542103,140,6,37,815,218,183,33,150,23,127,0,35,20,0,0,0,15,597,352,197,155,48,107,0,245,70,39,21,18,136,0,542103
14000US06037542104,140,6,37,695,179,142,86,56,16,40,0,37,0,20,11,9,17,516,227,176,51,10,41,0,289,104,38,7,31,147,0,542104
14000US06037542105,140,6,37,1007,271,240,133,107,0,107,0,31,0,25,17,8,6,736,472,367,105,55,50,0,264,63,91,56,35,110,0,542105
14000US06037542106,140,6,37,657,180,152,96,56,25,31,0,28,13,8,0,8,7,477,225,158,50,0,50,17,252,92,36,6,30,124,0,542106
14000US06037542200,140,6,37,1498,256,221,91,130,7,123,0,35,17,18,8,10,0,1242,704,445,259,35,224,0,538,217,131,31,100,190,0,542200
14000US06037542401,140,6,37,1191,221,165,80,85,19,66,0,56,22,19,0,19,15,970,435,232,203,93,110,0,535,244,114,29,85,177,0,542401
14000US06037542402,140,6,37,804,142,121,26,95,19,76,0,21,2,19,0,19,0,662,406,202,204,56,148,0,256,101,79,62,17,76,0,542402
14000US06037542501,140,6,37,1122,258,254,113,141,0,141,0,4,0,4,4,0,0,864,420,202,218,44,174,0,444,189,109,39,70,146,0,542501
14000US06037542502,140,6,37,1178,299,229,110,119,23,96,0,70,5,23,0,23,42,879,345,209,136,0,136,0,534,119,56,5,51,359,0,542502
14000US06037542601,140,6,37,663,198,182,86,96,6,90,0,16,8,8,0,8,0,465,261,174,87,0,87,0,204,77,69,32,37,58,0,542601
14000US06037542602,140,6,37,1405,324,242,136,106,9,97,0,82,12,0,0,0,70,1081,567,487,72,40,32,8,514,73,190,36,154,251,0,542602
14000US06037542700,140,6,37,1215,233,177,105,72,0,72,0,56,0,56,23,33,0,982,544,278,266,86,180,0,438,157,105,14,91,176,0,542700
14000US06037542800,140,6,37,901,146,141,69,72,12,60,0,5,0,5,0,5,0,755,350,283,51,0,51,16,405,101,83,0,83,221,0,542800
14000US06037542900,140,6,37,720,132,91,32,59,23,36,0,41,4,24,0,24,13,588,245,131,114,35,79,0,343,151,63,12,51,129,0,542900
14000US06037543000,140,6,37,1280,207,151,32,88,44,44,31,56,0,7,0,7,49,1073,531,315,193,38,155,23,542,101,82,25,57,359,0,543000
14000US06037543100,140,6,37,1751,203,175,37,138,0,138,0,28,0,19,0,19,9,1548,744,382,362,79,283,0,804,332,240,64,176,232,0,543100
14000US06037543201,140,6,37,923,161,143,60,83,11,72,0,18,0,14,0,14,4,762,372,167,205,57,148,0,390,105,135,23,112,150,0,543201
14000US06037543202,140,6,37,1096,227,203,53,150,25,125,0,24,4,0,0,0,20,869,483,295,188,62,126,0,386,84,85,37,48,217,0,543202
14000US06037543304,140,6,37,1943,68,50,20,30,9,21,0,18,18,0,0,0,0,1875,528,260,268,63,205,0,1347,690,175,60,115,482,0,543304
14000US06037543305,140,6,37,1031,85,38,0,38,0,38,0,47,15,32,0,32,0,946,252,118,134,53,81,0,694,174,120,32,88,400,0,543305
14000US06037543306,140,6,37,1975,85,85,29,56,0,56,0,0,0,0,0,0,0,1890,583,345,238,61,177,0,1307,572,416,113,303,319,0,543306
14000US06037543321,140,6,37,1750,86,54,29,25,0,25,0,32,0,32,0,32,0,1664,463,262,172,13,159,29,1201,520,319,46,273,362,0,543321
14000US06037543322,140,6,37,2068,21,21,0,21,0,21,0,0,0,0,0,0,0,2047,744,521,223,32,191,0,1303,660,215,48,167,428,0,543322
14000US06037543400,140,6,37,955,112,75,58,17,0,17,0,37,22,9,9,0,6,843,359,243,116,49,67,0,484,258,120,58,62,106,0,543400
14000US06037543501,140,6,37,2016,125,96,36,60,0,60,0,29,0,17,17,0,12,1891,675,349,326,187,139,0,1216,514,156,7,149,546,0,543501
14000US06037543502,140,6,37,1350,67,28,28,0,0,0,0,39,13,0,0,0,26,1283,507,282,225,46,179,0,776,469,64,19,45,243,0,543502
14000US06037543503,140,6,37,1731,83,42,28,14,0,14,0,41,8,33,8,25,0,1648,488,332,156,36,120,0,1160,297,190,124,66,673,0,543503
14000US06037543601,140,6,37,1060,110,81,64,17,0,17,0,29,10,0,0,0,19,950,523,432,91,13,78,0,427,217,95,33,62,115,0,543601
14000US06037543602,140,6,37,2566,123,100,9,54,16,38,37,23,0,11,0,11,12,2443,798,513,244,83,161,41,1645,568,339,145,194,738,0,543602
14000US06037543603,140,6,37,1492,58,0,0,0,0,0,0,58,10,19,7,12,29,1434,339,204,135,59,76,0,1095,432,130,57,73,533,0,543603
14000US06037543604,140,6,37,1348,31,25,19,6,0,6,0,6,0,0,0,0,6,1317,560,391,169,53,116,0,757,520,119,29,90,118,0,543604
14000US06037543701,140,6,37,644,53,49,24,25,0,25,0,4,0,4,0,4,0,591,272,208,64,3,61,0,319,187,55,4,51,77,0,543701
14000US06037543702,140,6,37,1779,163,119,103,16,6,10,0,44,25,0,0,0,19,1616,768,600,155,60,95,13,848,513,79,23,56,256,0,543702
14000US06037543703,140,6,37,943,57,57,53,4,0,4,0,0,0,0,0,0,0,886,355,226,129,14,115,0,531,335,74,4,70,122,0,543703
14000US06037543801,140,6,37,1458,40,40,9,31,0,31,0,0,0,0,0,0,0,1418,500,369,126,42,84,5,918,391,188,42,146,339,0,543801
14000US06037543802,140,6,37,1909,51,31,5,26,0,26,0,20,7,5,5,0,8,1858,785,451,334,89,245,0,1073,523,189,23,166,361,0,543802
14000US06037543903,140,6,37,989,55,47,11,36,11,25,0,8,8,0,0,0,0,934,393,299,65,8,57,29,541,174,196,100,96,171,0,543903
14000US06037543905,140,6,37,957,173,98,36,62,23,39,0,75,39,17,0,17,19,784,485,379,106,47,59,0,299,80,125,34,91,94,0,543905
14000US06037544001,140,6,37,1147,159,138,46,85,48,37,7,21,0,21,5,16,0,988,382,285,97,33,64,0,606,320,97,47,50,189,0,544001
14000US06037544002,140,6,37,797,11,11,11,0,0,0,0,0,0,0,0,0,0,786,347,247,100,80,20,0,439,226,68,50,18,145,0,544002
14000US06037550000,140,6,37,174,12,3,0,3,0,3,0,9,0,9,0,9,0,162,54,26,28,7,21,0,108,32,10,7,3,66,0,550000
14000US06037550100,140,6,37,1830,172,117,70,47,0,47,0,55,11,18,0,18,26,1658,756,589,167,16,151,0,902,340,346,141,205,216,0,550100
14000US06037550201,140,6,37,732,46,40,40,0,0,0,0,6,0,6,0,6,0,686,294,203,91,0,91,0,392,146,119,30,89,127,0,550201
14000US06037550202,140,6,37,1446,122,122,87,35,0,35,0,0,0,0,0,0,0,1324,588,473,115,104,11,0,736,261,211,81,130,264,0,550202
14000US06037550300,140,6,37,1990,123,98,73,25,14,11,0,25,0,0,0,0,25,1867,789,511,278,27,251,0,1078,373,263,63,200,442,0,550300
14000US06037550400,140,6,37,403,17,13,0,13,9,4,0,4,0,4,0,4,0,386,217,143,74,20,54,0,169,80,53,21,32,36,0,550400
14000US06037550500,140,6,37,2171,122,122,67,55,0,55,0,0,0,0,0,0,0,2049,677,516,161,15,146,0,1372,704,244,59,185,424,0,550500
14000US06037550601,140,6,37,1612,138,138,51,87,18,69,0,0,0,0,0,0,0,1474,584,388,196,43,153,0,890,336,159,47,112,395,0,550601
14000US06037550602,140,6,37,1211,61,61,24,37,0,37,0,0,0,0,0,0,0,1150,534,440,94,0,94,0,616,366,82,26,56,168,0,550602
14000US06037550700,140,6,37,1926,49,33,0,33,33,0,0,16,0,16,16,0,0,1877,689,544,145,34,111,0,1188,577,250,123,127,361,0,550700
14000US06037550800,140,6,37,2157,92,92,14,78,33,45,0,0,0,0,0,0,0,2065,782,555,227,108,119,0,1283,586,271,85,186,426,0,550800
14000US06037550901,140,6,37,1283,112,78,18,60,0,60,0,34,0,34,21,13,0,1171,440,213,227,6,221,0,731,259,181,59,122,291,0,550901
14000US06037550902,140,6,37,1829,126,115,58,57,0,57,0,11,0,11,0,11,0,1703,672,387,278,111,167,7,1031,318,208,88,120,505,0,550902
14000US06037551000,140,6,37,2246,72,47,0,0,0,0,47,25,19,6,0,6,0,2174,937,635,302,106,196,0,1237,626,140,17,123,471,0,551000
14000US06037551101,140,6,37,1166,179,170,44,126,10,116,0,9,0,9,9,0,0,987,364,214,150,55,95,0,623,281,109,54,55,233,0,551101
14000US06037551102,140,6,37,1627,176,145,29,116,0,116,0,31,7,0,0,0,24,1451,677,284,393,147,246,0,774,130,143,79,64,501,0,551102
14000US06037551201,140,6,37,1093,20,20,20,0,0,0,0,0,0,0,0,0,0,1073,494,341,153,49,104,0,579,242,109,44,65,228,0,551201
14000US06037551202,140,6,37,2092,81,18,9,9,0,9,0,63,0,50,50,0,13,2011,1056,546,494,137,357,16,955,421,244,43,201,290,0,551202
14000US06037551300,140,6,37,1778,93,76,35,41,0,41,0,17,9,0,0,0,8,1685,621,292,329,141,188,0,1064,285,262,91,171,517,0,551300
14000US06037551401,140,6,37,1384,117,117,7,110,40,70,0,0,0,0,0,0,0,1267,734,520,214,69,145,0,533,268,67,31,36,198,0,551401
14000US06037551402,140,6,37,1244,33,24,7,17,0,17,0,9,0,0,0,0,9,1211,518,441,77,49,28,0,693,313,120,69,51,260,0,551402
14000US06037551501,140,6,37,1419,72,60,0,60,12,48,0,12,12,0,0,0,0,1347,754,560,194,71,123,0,593,278,91,18,73,224,0,551501
14000US06037551502,140,6,37,1191,170,156,123,33,0,33,0,14,0,14,0,14,0,1021,408,304,104,8,96,0,613,320,91,39,52,202,0,551502
14000US06037551600,140,6,37,0,0,0,0,0,0,0,0,0,0,0,0,0,0,0,0,0,0,0,0,0,0,0,0,0,0,0,0,551600
14000US06037551700,140,6,37,1654,133,99,49,50,11,39,0,34,34,0,0,0,0,1521,816,511,305,114,191,0,705,294,190,81,109,221,0,551700
14000US06037551800,140,6,37,2297,117,80,52,28,0,28,0,37,12,25,0,25,0,2180,948,544,404,115,289,0,1232,443,260,93,167,529,0,551800
14000US06037551900,140,6,37,1450,115,105,43,62,9,53,0,10,0,0,0,0,10,1335,660,443,217,56,161,0,675,296,174,34,140,205,0,551900
14000US06037552001,140,6,37,990,30,20,0,20,11,9,0,10,0,10,0,10,0,960,448,353,88,40,48,7,512,194,147,0,147,171,0,552001
14000US06037552002,140,6,37,985,46,46,6,40,25,15,0,0,0,0,0,0,0,939,436,307,105,56,49,24,503,224,47,12,35,232,0,552002
14000US06037552100,140,6,37,1896,176,111,58,53,0,53,0,65,9,28,15,13,28,1720,549,408,141,11,130,0,1171,458,221,97,124,492,0,552100
14000US06037552200,140,6,37,1708,249,236,78,158,24,134,0,13,4,9,0,9,0,1459,702,444,258,25,233,0,757,258,300,125,175,199,0,552200
14000US06037552301,140,6,37,1253,152,124,41,83,0,83,0,28,0,28,28,0,0,1101,427,316,111,0,111,0,674,241,151,27,124,282,0,552301
14000US06037552302,140,6,37,1149,130,83,53,30,20,10,0,47,0,22,0,22,25,1019,296,169,127,24,103,0,723,229,136,52,84,358,0,552302
14000US06037552400,140,6,37,547,57,50,27,23,0,23,0,7,0,7,0,7,0,490,323,221,102,46,56,0,167,55,55,9,46,57,0,552400
14000US06037552601,140,6,37,1182,162,130,51,79,36,43,0,32,0,32,23,9,0,1020,584,452,132,18,114,0,436,196,119,17,102,121,0,552601
14000US06037552602,140,6,37,1100,80,80,14,66,11,55,0,0,0,0,0,0,0,1020,348,256,92,46,46,0,672,369,223,137,86,80,0,552602
14000US06037552700,140,6,37,1732,116,78,44,34,20,14,0,38,19,19,19,0,0,1616,843,683,160,17,143,0,773,356,228,157,71,189,0,552700
14000US06037552800,140,6,37,1589,148,141,107,34,8,26,0,7,0,7,0,7,0,1441,787,523,233,101,132,31,654,278,137,50,87,239,0,552800
14000US06037552900,140,6,37,1936,121,121,37,84,20,64,0,0,0,0,0,0,0,1815,661,394,267,68,199,0,1154,403,329,166,163,422,0,552900
14000US06037553000,140,6,37,1196,47,37,11,26,21,5,0,10,10,0,0,0,0,1149,543,424,119,69,50,0,606,369,132,42,90,105,0,553000
14000US06037553100,140,6,37,1879,112,52,18,34,11,23,0,60,22,14,0,14,24,1767,817,584,212,117,95,21,950,419,224,30,194,307,0,553100
14000US06037553200,140,6,37,1976,152,110,37,73,23,50,0,42,42,0,0,0,0,1824,817,631,186,69,117,0,1007,602,170,26,144,235,0,553200
14000US06037553300,140,6,37,961,108,103,21,82,7,75,0,5,0,5,0,5,0,853,265,180,85,41,44,0,588,189,186,20,166,213,0,553300
14000US06037553400,140,6,37,943,129,99,61,38,0,38,0,30,12,0,0,0,18,814,382,223,149,11,138,10,432,232,59,45,14,141,0,553400
14000US06037553502,140,6,37,1223,156,109,35,74,8,66,0,47,40,0,0,0,7,1067,444,291,153,58,95,0,623,176,111,46,65,336,0,553502
14000US06037553503,140,6,37,746,98,91,31,60,0,60,0,7,0,0,0,0,7,648,356,239,117,55,62,0,292,122,64,14,50,106,0,553503
14000US06037553504,140,6,37,1297,235,222,128,94,59,35,0,13,0,13,0,13,0,1062,700,377,303,107,196,20,362,178,67,39,28,117,0,553504
14000US06037553601,140,6,37,1218,143,132,64,68,25,43,0,11,0,11,0,11,0,1075,548,343,190,37,153,15,527,215,62,9,53,250,0,553601
14000US06037553602,140,6,37,1268,157,148,71,77,9,68,0,9,0,9,0,9,0,1111,522,356,166,44,122,0,589,181,135,70,65,273,0,553602
14000US06037553701,140,6,37,875,170,158,113,45,31,14,0,12,4,8,8,0,0,705,378,196,162,74,88,20,327,164,83,15,68,80,0,553701
14000US06037553702,140,6,37,1019,217,210,118,92,0,92,0,7,7,0,0,0,0,802,475,314,161,37,124,0,327,158,68,33,35,101,0,553702
14000US06037553801,140,6,37,1030,152,125,80,45,0,45,0,27,0,20,6,14,7,878,572,320,252,119,133,0,306,153,80,13,67,73,0,553801
14000US06037553802,140,6,37,1889,246,192,59,133,34,99,0,54,23,20,0,20,11,1643,716,371,314,147,167,31,927,311,132,63,69,484,0,553802
14000US06037553901,140,6,37,1699,160,154,39,115,17,98,0,6,0,0,0,0,6,1539,762,590,172,35,137,0,777,173,242,66,176,362,0,553901
14000US06037553902,140,6,37,1562,166,130,71,59,28,31,0,36,9,27,0,27,0,1396,695,403,292,152,140,0,701,251,121,63,58,329,0,553902
14000US06037554001,140,6,37,1182,34,34,9,25,8,17,0,0,0,0,0,0,0,1148,566,391,175,113,62,0,582,316,89,24,65,177,0,554001
14000US06037554002,140,6,37,1724,199,168,68,100,22,78,0,31,0,16,0,16,15,1525,546,425,121,43,78,0,979,280,198,91,107,501,0,554002
14000US06037554101,140,6,37,1044,168,152,109,22,0,22,21,16,9,0,0,0,7,876,470,232,238,94,144,0,406,179,61,20,41,166,0,554101
14000US06037554103,140,6,37,455,0,0,0,0,0,0,0,0,0,0,0,0,0,455,224,162,62,45,17,0,231,56,56,0,56,119,0,554103
14000US06037554104,140,6,37,782,53,49,0,49,8,41,0,4,0,4,0,4,0,729,285,253,32,0,32,0,444,228,44,7,37,172,0,554104
14000US06037554105,140,6,37,1559,221,196,45,151,0,151,0,25,0,25,12,13,0,1338,444,194,250,59,191,0,894,253,209,117,92,432,0,554105
14000US06037554201,140,6,37,1108,96,81,30,51,0,51,0,15,0,6,0,6,9,1012,368,277,66,8,58,25,644,225,169,17,152,250,0,554201
14000US06037554203,140,6,37,1177,47,12,0,12,0,12,0,35,35,0,0,0,0,1130,406,263,143,22,121,0,724,193,125,14,111,406,0,554203
14000US06037554204,140,6,37,1561,253,220,86,134,0,134,0,33,10,15,0,15,8,1308,464,205,259,72,187,0,844,163,85,20,65,596,0,554204
14000US06037554301,140,6,37,961,195,171,86,85,14,71,0,24,0,24,0,24,0,766,362,248,114,16,98,0,404,119,104,33,71,181,0,554301
14000US06037554302,140,6,37,1142,230,118,87,31,20,11,0,112,26,67,0,67,19,912,424,213,211,103,108,0,488,186,69,0,69,233,0,554302
14000US06037554403,140,6,37,1678,221,173,19,154,9,145,0,48,0,0,0,0,48,1457,806,508,298,55,243,0,651,198,71,27,44,382,0,554403
14000US06037554404,140,6,37,1324,249,218,132,74,18,56,12,31,9,0,0,0,22,1075,476,233,243,67,176,0,599,233,93,22,71,273,0,554404
14000US06037554405,140,6,37,1267,97,50,0,50,10,40,0,47,0,0,0,0,47,1170,363,230,133,14,119,0,807,142,128,20,108,537,0,554405
14000US06037554406,140,6,37,1729,51,9,0,9,0,9,0,42,0,0,0,0,42,1678,658,332,292,46,246,34,1020,356,169,53,116,495,0,554406
14000US06037554511,140,6,37,1139,0,0,0,0,0,0,0,0,0,0,0,0,0,1139,577,533,44,0,44,0,562,423,74,44,30,65,0,554511
14000US06037554512,140,6,37,1796,21,9,9,0,0,0,0,12,0,4,0,4,8,1775,726,667,59,8,51,0,1049,625,133,67,66,291,0,554512
14000US06037554513,140,6,37,801,6,0,0,0,0,0,0,6,0,6,0,6,0,795,320,289,31,10,21,0,475,274,68,13,55,133,0,554513
14000US06037554514,140,6,37,1438,20,20,20,0,0,0,0,0,0,0,0,0,0,1418,542,355,179,26,153,8,876,485,162,64,98,229,0,554514
14000US06037554515,140,6,37,1094,33,25,25,0,0,0,0,8,0,0,0,0,8,1061,362,299,63,17,46,0,699,461,111,42,69,127,0,554515
14000US06037554516,140,6,37,1148,11,0,0,0,0,0,0,11,11,0,0,0,0,1137,398,250,148,30,118,0,739,457,157,32,125,125,0,554516
14000US06037554517,140,6,37,1498,36,28,9,19,0,19,0,8,8,0,0,0,0,1462,586,509,77,32,45,0,876,559,87,44,43,230,0,554517
14000US06037554518,140,6,37,1624,12,0,0,0,0,0,0,12,0,12,12,0,0,1612,557,489,68,16,52,0,1055,756,169,41,128,130,0,554518
14000US06037554519,140,6,37,1159,15,15,15,0,0,0,0,0,0,0,0,0,0,1144,293,280,13,0,13,0,851,633,80,6,74,138,0,554519
14000US06037554521,140,6,37,1893,0,0,0,0,0,0,0,0,0,0,0,0,0,1893,561,398,132,68,64,31,1332,669,209,64,145,454,0,554521
14000US06037554522,140,6,37,1486,47,47,47,0,0,0,0,0,0,0,0,0,0,1439,463,336,127,0,127,0,976,598,201,86,115,177,0,554522
14000US06037554600,140,6,37,1290,111,85,24,61,0,61,0,26,0,0,0,0,26,1179,372,194,178,39,139,0,807,304,304,121,183,199,0,554600
14000US06037554700,140,6,37,1010,101,89,58,31,15,16,0,12,2,10,0,10,0,909,479,342,137,27,110,0,430,255,95,33,62,80,0,554700
14000US06037554801,140,6,37,735,129,129,11,118,32,86,0,0,0,0,0,0,0,606,257,193,64,20,44,0,349,122,151,115,36,76,0,554801
14000US06037554802,140,6,37,1784,37,30,12,18,0,18,0,7,7,0,0,0,0,1747,689,549,140,79,61,0,1058,539,280,107,173,239,0,554802
14000US06037554900,140,6,37,2035,11,11,0,11,0,11,0,0,0,0,0,0,0,2024,604,364,240,51,189,0,1420,856,210,44,166,354,0,554900
14000US06037555001,140,6,37,1589,133,133,91,42,11,31,0,0,0,0,0,0,0,1456,469,269,200,36,164,0,987,526,158,79,79,303,0,555001
14000US06037555002,140,6,37,1109,144,119,26,93,0,93,0,25,0,15,0,15,10,965,380,204,176,69,107,0,585,215,75,0,75,295,0,555002
14000US06037555102,140,6,37,1983,236,168,38,130,0,130,0,68,24,44,19,25,0,1747,809,480,329,16,313,0,938,471,246,62,184,221,0,555102
14000US06037555103,140,6,37,1338,56,47,47,0,0,0,0,9,9,0,0,0,0,1282,502,326,176,66,110,0,780,388,148,56,92,244,0,555103
14000US06037555104,140,6,37,1336,79,36,4,32,0,32,0,43,35,0,0,0,8,1257,558,513,37,5,32,8,699,179,219,89,130,301,0,555104
14000US06037555202,140,6,37,1172,20,12,12,0,0,0,0,8,8,0,0,0,0,1152,398,334,64,39,25,0,754,324,106,47,59,324,0,555202
14000US06037555211,140,6,37,1285,210,193,98,95,10,85,0,17,0,8,0,8,9,1075,473,391,69,45,24,13,602,272,134,47,87,196,0,555211
14000US06037555212,140,6,37,1234,220,192,53,139,84,55,0,28,2,0,0,0,26,1014,521,417,104,10,94,0,493,191,134,25,109,168,0,555212
14000US06037570001,140,6,37,1389,45,22,22,0,0,0,0,23,0,23,10,13,0,1344,565,431,121,26,95,13,779,411,60,15,45,308,0,570001
14000US06037570002,140,6,37,841,16,10,10,0,0,0,0,6,0,0,0,0,6,825,356,274,82,30,52,0,469,179,65,16,49,225,0,570002
14000US06037570003,140,6,37,1445,50,23,0,23,0,23,0,27,15,12,12,0,0,1395,645,483,162,55,107,0,750,313,106,31,75,331,0,570003
14000US06037570100,140,6,37,736,11,5,5,0,0,0,0,6,6,0,0,0,0,725,263,186,77,54,23,0,462,266,116,19,97,80,0,570100
14000US06037570202,140,6,37,1607,216,202,71,131,24,107,0,14,8,0,0,0,6,1391,697,499,198,91,107,0,694,143,200,110,90,351,0,570202
14000US06037570203,140,6,37,1139,239,190,52,119,27,92,19,49,0,22,8,14,27,900,427,226,201,113,88,0,473,149,87,20,67,237,0,570203
14000US06037570204,140,6,37,998,183,126,20,106,16,90,0,57,38,0,0,0,19,815,367,196,171,83,88,0,448,185,118,50,68,145,0,570204
14000US06037570301,140,6,37,2151,469,383,68,315,25,290,0,86,0,34,0,34,52,1682,607,339,268,91,177,0,1075,185,197,68,129,693,0,570301
14000US06037570303,140,6,37,1133,196,91,50,41,0,41,0,105,0,41,0,41,64,937,401,187,214,111,103,0,536,172,89,26,63,275,0,570303
14000US06037570304,140,6,37,1451,340,304,123,181,8,173,0,36,0,10,0,10,26,1111,483,389,94,26,68,0,628,207,149,95,54,272,0,570304
14000US06037570402,140,6,37,932,61,38,27,11,0,11,0,23,9,7,0,7,7,871,398,305,83,35,48,10,473,191,119,79,40,163,0,570402
14000US06037570403,140,6,37,1096,307,256,44,212,36,176,0,51,17,24,24,0,10,789,486,195,291,83,208,0,303,117,44,0,44,142,0,570403
14000US06037570404,140,6,37,818,202,142,50,92,38,54,0,60,32,8,8,0,20,616,320,227,93,5,88,0,296,134,98,49,49,64,0,570404
14000US06037570501,140,6,37,2198,116,83,0,83,0,83,0,33,17,16,0,16,0,2082,1085,785,300,122,178,0,997,293,97,82,15,607,0,570501
14000US06037570502,140,6,37,1810,254,202,88,114,14,100,0,52,9,0,0,0,43,1556,748,436,308,117,191,4,808,411,126,57,69,271,0,570502
14000US06037570601,140,6,37,1493,178,137,36,101,16,85,0,41,0,41,26,15,0,1315,584,328,249,73,176,7,731,288,127,15,112,316,0,570601
14000US06037570602,140,6,37,1819,289,244,87,157,34,123,0,45,11,34,34,0,0,1530,733,516,208,96,112,9,797,255,146,60,86,396,0,570602
14000US06037570603,140,6,37,1599,340,237,0,237,38,199,0,103,0,62,0,62,41,1259,466,139,316,17,299,11,793,213,104,20,84,476,0,570603
14000US06037570701,140,6,37,2441,103,35,11,24,0,24,0,68,0,24,0,24,44,2338,861,479,382,78,304,0,1477,579,135,6,129,763,0,570701
14000US06037570702,140,6,37,841,28,28,0,28,0,28,0,0,0,0,0,0,0,813,295,214,75,37,38,6,518,195,62,5,57,261,0,570702
14000US06037570800,140,6,37,1839,74,59,0,59,0,59,0,15,0,7,0,7,8,1765,708,522,186,81,105,0,1057,540,215,56,159,302,0,570800
14000US06037570901,140,6,37,1876,14,0,0,0,0,0,0,14,14,0,0,0,0,1862,723,588,135,44,91,0,1139,527,130,53,77,482,0,570901
14000US06037570902,140,6,37,1244,11,0,0,0,0,0,0,11,11,0,0,0,0,1233,490,335,155,36,119,0,743,244,208,66,142,291,0,570902
14000US06037571000,140,6,37,1942,19,13,13,0,0,0,0,6,0,0,0,0,6,1923,715,536,179,101,78,0,1208,660,124,55,69,424,0,571000
14000US06037571101,140,6,37,1555,9,0,0,0,0,0,0,9,0,0,0,0,9,1546,611,480,131,37,94,0,935,531,98,29,69,306,0,571101
14000US06037571102,140,6,37,1359,0,0,0,0,0,0,0,0,0,0,0,0,0,1359,478,333,145,22,123,0,881,344,135,62,73,402,0,571102
14000US06037571200,140,6,37,3084,65,15,15,0,0,0,0,50,0,0,0,0,50,3019,853,605,248,0,248,0,2166,927,187,84,103,1052,0,571200
14000US06037571300,140,6,37,1441,28,8,0,8,0,8,0,20,0,20,10,10,0,1413,346,232,114,11,103,0,1067,442,188,71,117,437,0,571300
14000US06037571400,140,6,37,1699,47,11,11,0,0,0,0,36,9,21,21,0,6,1652,515,353,162,43,119,0,1137,402,200,94,106,535,0,571400
14000US06037571502,140,6,37,1720,92,26,17,9,0,9,0,66,6,38,9,29,22,1628,606,411,195,9,186,0,1022,335,109,27,82,578,0,571502
14000US06037571503,140,6,37,1189,74,65,39,26,0,26,0,9,0,0,0,0,9,1115,369,237,108,0,108,24,746,338,103,84,19,305,0,571503
14000US06037571504,140,6,37,1799,123,123,33,90,0,90,0,0,0,0,0,0,0,1676,386,262,124,7,117,0,1290,411,197,28,169,682,0,571504
14000US06037571600,140,6,37,766,286,228,0,228,0,228,0,58,0,17,0,17,41,480,182,44,138,13,125,0,298,20,46,12,34,232,0,571600
14000US06037571701,140,6,37,1711,254,204,53,151,59,92,0,50,0,41,8,33,9,1457,722,467,243,133,110,12,735,325,131,68,63,279,0,571701
14000US06037571703,140,6,37,1044,123,95,32,63,0,63,0,28,0,27,0,27,1,921,325,179,146,20,126,0,596,175,85,35,50,336,0,571703
14000US06037571704,140,6,37,1101,221,172,15,157,47,110,0,49,0,24,0,24,25,880,395,239,156,40,116,0,485,220,99,19,80,166,0,571704
14000US06037571800,140,6,37,1332,7,0,0,0,0,0,0,7,7,0,0,0,0,1325,318,283,35,12,23,0,1007,485,45,17,28,477,0,571800
14000US06037571900,140,6,37,2404,120,75,0,75,0,75,0,45,0,0,0,0,45,2284,679,402,277,163,114,0,1605,583,133,25,108,889,0,571900
14000US06037572001,140,6,37,2209,30,19,0,19,0,19,0,11,0,11,0,11,0,2179,586,363,203,114,89,20,1593,672,86,17,69,835,0,572001
14000US06037572002,140,6,37,1768,31,26,23,3,0,3,0,5,0,5,0,5,0,1737,475,285,190,33,157,0,1262,328,90,12,78,844,0,572002
14000US06037572100,140,6,37,318,0,0,0,0,0,0,0,0,0,0,0,0,0,318,125,82,43,0,43,0,193,70,49,18,31,74,0,572100
14000US06037572201,140,6,37,2098,234,68,50,18,0,18,0,166,25,13,0,13,128,1864,588,368,220,129,91,0,1276,380,262,52,210,634,0,572201
14000US06037572202,140,6,37,1045,63,48,35,13,0,13,0,15,0,15,0,15,0,982,376,212,164,78,86,0,606,241,89,28,61,276,0,572202
14000US06037572301,140,6,37,977,135,89,80,9,0,9,0,46,18,28,0,28,0,842,423,305,118,26,92,0,419,171,112,51,61,136,0,572301
14000US06037572302,140,6,37,835,127,98,40,58,25,33,0,29,15,6,0,6,8,708,431,295,136,33,103,0,277,120,61,5,56,96,0,572302
14000US06037572400,140,6,37,267,31,27,13,14,0,14,0,4,4,0,0,0,0,236,81,35,46,14,32,0,155,70,61,23,38,24,0,572400
14000US06037572500,140,6,37,1234,378,235,56,179,26,153,0,143,0,98,36,62,45,856,165,82,83,11,72,0,691,204,59,8,51,428,0,572500
14000US06037572600,140,6,37,1283,120,51,40,11,11,0,0,69,24,45,0,45,0,1163,559,424,135,67,68,0,604,349,72,27,45,183,0,572600
14000US06037572700,140,6,37,1338,169,99,34,65,29,36,0,70,29,29,0,29,12,1169,576,424,152,0,152,0,593,245,160,44,116,188,0,572700
14000US06037572800,140,6,37,277,63,55,7,48,22,26,0,8,0,0,0,0,8,214,46,27,19,0,19,0,168,11,18,0,18,139,0,572800
14000US06037572900,140,6,37,1276,308,239,73,166,39,127,0,69,10,59,28,31,0,968,456,301,155,27,128,0,512,233,129,78,51,150,0,572900
14000US06037573002,140,6,37,1103,292,281,68,213,36,177,0,11,0,0,0,0,11,811,373,202,171,75,96,0,438,84,145,48,97,209,0,573002
14000US06037573003,140,6,37,567,90,62,58,4,0,4,0,28,0,20,0,20,8,477,275,202,73,21,52,0,202,44,31,4,27,127,0,573003
14000US06037573004,140,6,37,1510,434,360,66,271,78,193,23,74,0,32,0,32,42,1076,555,230,307,86,221,18,521,29,214,110,104,278,0,573004
14000US06037573100,140,6,37,2400,340,182,60,122,0,122,0,158,11,39,0,39,108,2060,806,527,279,171,108,0,1254,329,272,0,272,653,0,573100
14000US06037573201,140,6,37,1355,239,180,65,115,22,93,0,59,34,0,0,0,25,1116,607,371,236,129,107,0,509,102,99,51,48,308,0,573201
14000US06037573202,140,6,37,1506,461,367,123,244,36,208,0,94,17,40,40,0,37,1045,535,388,147,60,87,0,510,105,124,31,93,281,0,573202
14000US06037573300,140,6,37,999,382,312,121,178,53,125,13,70,0,32,0,32,38,617,279,183,96,49,47,0,338,90,112,35,77,136,0,573300
14000US06037573401,140,6,37,494,46,36,6,30,10,20,0,10,0,0,0,0,10,448,227,161,66,11,55,0,221,34,51,0,51,136,0,573401
14000US06037573402,140,6,37,2220,137,107,0,107,20,87,0,30,12,0,0,0,18,2083,832,496,325,57,268,11,1251,344,97,10,87,810,0,573402
14000US06037573403,140,6,37,1282,10,10,0,10,0,10,0,0,0,0,0,0,0,1272,347,281,66,49,17,0,925,334,120,54,66,471,0,573403
14000US06037573601,140,6,37,2349,19,13,0,13,0,13,0,6,6,0,0,0,0,2330,787,639,148,50,98,0,1543,675,168,13,155,700,0,573601
14000US06037573700,140,6,37,1710,30,30,0,30,0,30,0,0,0,0,0,0,0,1680,511,348,163,48,115,0,1169,567,153,75,78,449,0,573700
14000US06037573800,140,6,37,1525,16,9,9,0,0,0,0,7,7,0,0,0,0,1509,552,458,94,46,48,0,957,474,175,60,115,308,0,573800
14000US06037573902,140,6,37,881,23,23,0,23,0,23,0,0,0,0,0,0,0,858,232,197,35,0,35,0,626,337,32,20,12,257,0,573902
14000US06037574000,140,6,37,1969,21,21,15,6,0,6,0,0,0,0,0,0,0,1948,657,531,126,23,103,0,1291,579,227,83,144,485,0,574000
14000US06037574100,140,6,37,1902,63,56,8,48,0,48,0,7,0,0,0,0,7,1839,618,444,174,0,174,0,1221,603,177,58,119,441,0,574100
14000US06037574201,140,6,37,1107,0,0,0,0,0,0,0,0,0,0,0,0,0,1107,317,275,32,27,5,10,790,373,99,0,99,318,0,574201
14000US06037574202,140,6,37,688,13,13,0,13,0,13,0,0,0,0,0,0,0,675,254,179,72,23,49,3,421,104,81,14,67,236,0,574202
14000US06037574300,140,6,37,2184,21,0,0,0,0,0,0,21,0,21,0,21,0,2163,712,492,220,9,211,0,1451,517,342,112,230,592,0,574300
14000US06037574400,140,6,37,1977,13,11,0,11,11,0,0,2,0,2,2,0,0,1964,631,580,51,0,51,0,1333,722,96,10,86,515,0,574400
14000US06037574500,140,6,37,2256,0,0,0,0,0,0,0,0,0,0,0,0,0,2256,633,552,81,16,65,0,1623,725,186,108,78,712,0,574500
14000US06037574601,140,6,37,0,0,0,0,0,0,0,0,0,0,0,0,0,0,0,0,0,0,0,0,0,0,0,0,0,0,0,0,574601
14000US06037574602,140,6,37,560,0,0,0,0,0,0,0,0,0,0,0,0,0,560,106,66,40,28,12,0,454,223,22,0,22,209,0,574602
14000US06037574700,140,6,37,0,0,0,0,0,0,0,0,0,0,0,0,0,0,0,0,0,0,0,0,0,0,0,0,0,0,0,0,574700
14000US06037574800,140,6,37,1448,8,8,8,0,0,0,0,0,0,0,0,0,0,1440,283,171,112,24,88,0,1157,345,114,58,56,698,0,574800
14000US06037574901,140,6,37,1434,47,40,40,0,0,0,0,7,0,0,0,0,7,1387,443,399,44,26,18,0,944,345,185,26,159,414,0,574901
14000US06037574902,140,6,37,1842,29,24,5,19,0,19,0,5,5,0,0,0,0,1813,362,221,141,87,54,0,1451,323,102,38,64,1026,0,574902
14000US06037575001,140,6,37,1619,15,9,9,0,0,0,0,6,0,0,0,0,6,1604,419,375,44,9,35,0,1185,266,104,29,75,815,0,575001
14000US06037575002,140,6,37,1976,93,41,8,33,33,0,0,52,0,29,11,18,23,1883,429,218,211,69,142,0,1454,286,86,53,33,1082,0,575002
14000US06037575101,140,6,37,1397,337,296,110,186,0,186,0,41,0,34,0,34,7,1060,470,222,240,148,92,8,590,168,130,31,99,292,0,575101
14000US06037575102,140,6,37,1198,373,350,82,268,82,186,0,23,0,9,0,9,14,825,342,157,176,48,128,9,483,158,134,64,70,191,0,575102
14000US06037575103,140,6,37,1982,292,197,69,128,13,115,0,95,15,57,17,40,23,1690,493,297,196,64,132,0,1197,173,207,75,132,817,0,575103
14000US06037575201,140,6,37,1311,281,269,123,146,37,109,0,12,0,12,0,12,0,1030,480,207,273,56,217,0,550,115,125,49,76,310,0,575201
14000US06037575202,140,6,37,1238,379,308,117,191,116,75,0,71,30,17,17,0,24,859,369,185,184,93,91,0,490,208,103,67,36,179,0,575202
14000US06037575300,140,6,37,1274,459,399,138,261,35,226,0,60,8,42,0,42,10,815,376,190,186,106,80,0,439,89,67,5,62,283,0,575300
14000US06037575401,140,6,37,1206,339,282,105,177,71,106,0,57,22,12,5,7,23,867,382,224,158,40,118,0,485,133,114,34,80,238,0,575401
14000US06037575402,140,6,37,1040,336,319,117,202,59,143,0,17,9,5,0,5,3,704,376,199,177,40,137,0,328,72,55,18,37,201,0,575402
14000US06037575500,140,6,37,8,0,0,0,0,0,0,0,0,0,0,0,0,0,8,4,4,0,0,0,0,4,0,0,0,0,4,0,575500
14000US06037575801,140,6,37,682,235,169,62,107,7,100,0,66,0,50,17,33,16,447,162,113,43,13,30,6,285,18,72,20,52,195,0,575801
14000US06037575802,140,6,37,1519,464,318,131,187,73,114,0,146,0,114,39,75,32,1055,374,158,216,85,131,0,681,108,96,47,49,477,0,575802
14000US06037575803,140,6,37,1150,277,161,49,112,39,73,0,116,11,0,0,0,105,873,145,41,104,33,71,0,728,94,60,28,32,574,0,575803
14000US06037575901,140,6,37,1209,234,166,22,144,9,135,0,68,0,15,0,15,53,975,207,91,116,19,97,0,768,134,84,66,18,550,0,575901
14000US06037575902,140,6,37,2759,235,115,0,115,0,115,0,120,0,8,0,8,112,2524,279,48,223,86,137,8,2245,245,73,2,71,1927,0,575902
14000US06037576001,140,6,37,3009,115,51,0,38,0,38,13,64,0,0,0,0,64,2894,386,277,109,0,109,0,2508,468,94,45,49,1946,0,576001
14000US06037576200,140,6,37,2773,390,222,68,154,59,95,0,168,0,0,0,0,168,2383,491,358,103,0,103,30,1892,156,134,61,73,1602,0,576200
14000US06037576301,140,6,37,1600,246,177,81,96,11,85,0,69,0,27,0,27,42,1354,347,187,160,79,81,0,1007,142,159,71,88,706,0,576301
14000US06037576302,140,6,37,1175,277,256,108,148,43,105,0,21,0,5,0,5,16,898,346,207,139,20,119,0,552,148,99,48,51,305,0,576302
14000US06037576401,140,6,37,1195,409,360,125,235,89,146,0,49,0,25,0,25,24,786,376,130,240,103,137,6,410,95,118,94,24,197,0,576401
14000US06037576402,140,6,37,1281,360,352,97,255,47,208,0,8,0,8,0,8,0,921,391,165,226,55,171,0,530,74,75,15,60,381,0,576402
14000US06037576403,140,6,37,1461,482,395,92,303,75,228,0,87,22,18,0,18,47,979,437,225,212,20,192,0,542,97,136,26,110,309,0,576403
14000US06037576501,140,6,37,1500,144,69,14,55,0,55,0,75,13,26,0,26,36,1356,229,77,152,43,109,0,1127,55,177,10,167,895,0,576501
14000US06037576502,140,6,37,2094,356,275,39,236,50,186,0,81,0,34,0,34,47,1738,261,106,155,31,124,0,1477,212,121,12,109,1144,0,576502
14000US06037576503,140,6,37,1825,231,133,67,66,66,0,0,98,7,35,0,35,56,1594,335,134,201,81,120,0,1259,103,230,93,137,926,0,576503
14000US06037576601,140,6,37,2854,116,49,0,49,19,30,0,67,26,0,0,0,41,2738,163,49,114,47,67,0,2575,436,24,24,0,2115,0,576601
14000US06037576602,140,6,37,2571,75,18,18,0,0,0,0,57,0,0,0,0,57,2496,155,125,30,0,30,0,2341,291,126,46,80,1924,0,576602
14000US06037576700,140,6,37,2197,15,0,0,0,0,0,0,15,0,0,0,0,15,2182,428,224,204,68,136,0,1754,414,60,22,38,1280,0,576700
14000US06037576801,140,6,37,1926,81,17,17,0,0,0,0,64,0,33,33,0,31,1845,259,83,176,52,124,0,1586,330,196,91,105,1060,0,576801
14000US06037576802,140,6,37,1883,119,66,0,66,0,66,0,53,0,0,0,0,53,1764,313,205,91,48,43,17,1451,199,140,37,103,1112,0,576802
14000US06037576901,140,6,37,1853,299,279,100,179,38,141,0,20,6,0,0,0,14,1554,629,431,190,77,113,8,925,191,145,74,71,589,0,576901
14000US06037576903,140,6,37,1403,270,180,92,88,22,66,0,90,0,34,0,34,56,1133,512,240,250,34,216,22,621,85,67,29,38,469,0,576903
14000US06037576904,140,6,37,1166,121,111,47,64,0,64,0,10,10,0,0,0,0,1045,161,95,66,0,66,0,884,202,65,0,65,617,0,576904
14000US06037577000,140,6,37,3038,131,26,12,14,0,14,0,105,0,39,0,39,66,2907,583,276,307,37,270,0,2324,487,303,77,226,1534,0,577000
14000US06037577100,140,6,37,3467,54,42,42,0,0,0,0,12,0,12,0,12,0,3413,582,386,196,58,138,0,2831,571,179,87,92,2081,0,577100
14000US06037577200,140,6,37,3240,0,0,0,0,0,0,0,0,0,0,0,0,0,3240,173,71,102,49,53,0,3067,530,143,27,116,2394,0,577200
14000US06037577300,140,6,37,2989,29,0,0,0,0,0,0,29,0,12,0,12,17,2960,235,142,93,59,34,0,2725,399,138,34,104,2188,0,577300
14000US06037577400,140,6,37,1624,11,0,0,0,0,0,0,11,11,0,0,0,0,1613,213,166,47,25,22,0,1400,276,27,0,27,1097,0,577400
14000US06037577501,140,6,37,1710,15,0,0,0,0,0,0,15,0,0,0,0,15,1695,354,273,81,9,72,0,1341,474,74,0,74,793,0,577501
14000US06037577504,140,6,37,690,0,0,0,0,0,0,0,0,0,0,0,0,0,690,74,49,25,21,4,0,616,173,16,0,16,427,0,577504
14000US06037577602,140,6,37,1650,21,10,0,10,10,0,0,11,0,0,0,0,11,1629,303,232,71,30,41,0,1326,447,73,21,52,806,0,577602
14000US06037577603,140,6,37,3755,58,14,0,14,0,14,0,44,0,0,0,0,44,3697,562,471,91,13,78,0,3135,1326,112,15,97,1697,0,577603
14000US06037577604,140,6,37,732,0,0,0,0,0,0,0,0,0,0,0,0,0,732,95,60,35,28,7,0,637,204,5,0,5,428,0,577604
14000US06037599000,140,6,37,1192,67,40,27,13,13,0,0,27,0,0,0,0,27,1125,472,329,143,39,104,0,653,250,62,51,11,341,0,599000
14000US06037599100,140,6,37,118,9,9,0,9,9,0,0,0,0,0,0,0,0,109,17,17,0,0,0,0,92,43,0,0,0,49,0,599100
14000US06037600100,140,6,37,1989,763,568,162,406,37,369,0,195,21,40,7,33,134,1226,544,215,329,118,211,0,682,135,102,41,61,445,0,600100
14000US06037600201,140,6,37,1182,196,173,57,116,9,107,0,23,0,23,0,23,0,986,428,301,127,42,85,0,558,78,190,47,143,290,0,600201
14000US06037600202,140,6,37,2093,371,250,69,181,21,160,0,121,10,35,16,19,76,1722,623,197,426,139,287,0,1099,193,366,124,242,540,0,600202
14000US06037600302,140,6,37,1033,105,98,2,96,29,67,0,7,7,0,0,0,0,928,246,148,98,4,94,0,682,203,169,25,144,310,0,600302
14000US06037600303,140,6,37,1140,411,252,105,147,0,147,0,159,25,69,22,47,65,729,223,61,162,23,139,0,506,135,133,67,66,238,0,600303
14000US06037600304,140,6,37,969,202,89,46,43,11,32,0,113,5,29,0,29,79,767,255,118,137,0,137,0,512,109,117,26,91,286,0,600304
14000US06037600400,140,6,37,1512,197,128,0,128,0,128,0,69,0,30,8,22,39,1315,320,162,135,69,66,23,995,212,265,7,258,518,0,600400
14000US06037600501,140,6,37,902,46,22,2,20,7,13,0,24,0,24,0,24,0,856,256,143,113,35,78,0,600,129,245,55,190,226,0,600501
14000US06037600502,140,6,37,680,14,7,0,7,0,7,0,7,3,0,0,0,4,666,305,187,118,51,67,0,361,144,85,11,74,132,0,600502
14000US06037600601,140,6,37,831,47,47,6,41,0,41,0,0,0,0,0,0,0,784,294,108,186,59,127,0,490,161,131,67,64,198,0,600601
14000US06037600602,140,6,37,701,215,169,53,105,62,43,11,46,12,23,0,23,11,486,229,149,80,18,62,0,257,46,66,30,36,145,0,600602
14000US06037600702,140,6,37,1297,77,77,4,73,0,73,0,0,0,0,0,0,0,1220,467,282,185,35,150,0,753,260,160,42,118,333,0,600702
14000US06037600703,140,6,37,902,0,0,0,0,0,0,0,0,0,0,0,0,0,902,83,39,44,0,44,0,819,180,227,25,202,412,0,600703
14000US06037600704,140,6,37,1213,75,42,27,15,0,15,0,33,0,33,0,33,0,1138,402,223,160,44,116,19,736,161,107,24,83,468,0,600704
14000US06037600801,140,6,37,1230,35,28,0,28,0,28,0,7,0,7,0,7,0,1195,335,104,200,11,189,31,860,266,171,59,112,423,0,600801
14000US06037600802,140,6,37,1148,99,53,0,53,27,26,0,46,0,38,0,38,8,1049,286,132,154,10,144,0,763,203,50,0,50,510,0,600802
14000US06037600902,140,6,37,2515,251,211,56,155,0,155,0,40,13,0,0,0,27,2264,827,543,284,59,225,0,1437,166,426,157,269,845,0,600902
14000US06037600911,140,6,37,1086,121,98,17,81,0,81,0,23,0,23,0,23,0,965,353,263,90,56,34,0,612,231,73,25,48,308,0,600911
14000US06037600912,140,6,37,1515,236,183,91,71,11,60,21,53,12,24,0,24,17,1279,624,357,267,97,170,0,655,217,214,84,130,224,0,600912
14000US06037601001,140,6,37,1025,89,48,12,36,0,36,0,41,0,16,7,9,25,936,162,83,79,13,66,0,774,84,79,29,50,611,0,601001
14000US06037601002,140,6,37,2121,353,248,69,179,26,153,0,105,30,11,11,0,64,1768,566,292,247,48,199,27,1202,203,223,38,185,776,0,601002
14000US06037601100,140,6,37,2128,265,217,71,146,13,133,0,48,14,0,0,0,34,1863,581,185,385,122,263,11,1282,392,101,20,81,789,0,601100
14000US06037601202,140,6,37,1061,162,130,88,42,0,42,0,32,20,0,0,0,12,899,355,260,95,45,50,0,544,220,130,65,65,194,0,601202
14000US06037601211,140,6,37,1087,95,66,31,35,0,35,0,29,10,6,0,6,13,992,233,131,85,19,66,17,759,109,124,38,86,526,0,601211
14000US06037601212,140,6,37,2058,274,259,134,125,0,125,0,15,0,0,0,0,15,1784,779,459,320,0,320,0,1005,185,244,92,152,576,0,601212
14000US06037601301,140,6,37,747,28,19,0,19,14,5,0,9,3,6,0,6,0,719,183,98,85,28,57,0,536,191,52,10,42,293,0,601301
14000US06037601302,140,6,37,2914,477,203,14,189,98,91,0,274,53,165,90,75,56,2437,843,388,455,36,419,0,1594,264,191,72,119,1139,0,601302
14000US06037601303,140,6,37,2061,235,143,14,129,30,99,0,92,25,25,0,25,42,1826,682,193,489,116,373,0,1144,110,170,0,170,864,0,601303
14000US06037601401,140,6,37,1520,246,159,12,147,20,127,0,87,14,28,18,10,45,1274,484,270,214,70,144,0,790,234,98,34,64,458,0,601401
14000US06037601402,140,6,37,1372,87,69,14,55,0,55,0,18,0,11,0,11,7,1285,483,322,161,43,118,0,802,369,112,37,75,321,0,601402
14000US06037601501,140,6,37,1094,185,148,89,59,0,59,0,37,0,0,0,0,37,909,554,413,141,85,56,0,355,152,52,19,33,151,0,601501
14000US06037601502,140,6,37,852,109,51,27,24,0,24,0,58,40,18,0,18,0,743,424,326,98,16,82,0,319,169,78,59,19,72,0,601502
14000US06037601600,140,6,37,1026,107,93,14,79,51,28,0,14,0,14,14,0,0,919,569,312,257,36,221,0,350,110,128,59,69,112,0,601600
14000US06037601700,140,6,37,1335,253,243,84,159,48,111,0,10,0,10,10,0,0,1082,622,420,202,75,127,0,460,211,102,66,36,147,0,601700
14000US06037601801,140,6,37,860,145,94,44,50,38,12,0,51,0,12,0,12,39,715,380,315,65,12,53,0,335,154,85,37,48,96,0,601801
14000US06037601802,140,6,37,1013,156,130,56,74,11,63,0,26,11,15,0,15,0,857,489,306,158,46,112,25,368,126,120,30,90,122,0,601802
14000US06037601900,140,6,37,1250,259,250,76,174,15,159,0,9,9,0,0,0,0,991,673,325,328,74,254,20,318,135,93,24,69,90,0,601900
14000US06037602002,140,6,37,833,124,79,40,39,19,20,0,45,3,9,9,0,33,709,337,165,172,61,111,0,372,120,116,52,64,136,0,602002
14000US06037602003,140,6,37,1288,232,201,63,138,0,138,0,31,0,0,0,0,31,1056,514,323,189,94,95,2,542,277,115,34,81,150,0,602003
14000US06037602004,140,6,37,995,215,176,53,123,29,94,0,39,0,16,0,16,23,780,386,241,145,45,100,0,394,164,91,30,61,139,0,602004
14000US06037602103,140,6,37,2045,274,194,93,101,0,101,0,80,0,39,0,39,41,1771,965,432,533,129,404,0,806,185,197,38,159,424,0,602103
14000US06037602104,140,6,37,1730,212,187,77,110,9,101,0,25,9,16,0,16,0,1518,725,380,345,90,255,0,793,160,202,84,118,431,0,602104
14000US06037602105,140,6,37,1401,237,191,63,128,0,128,0,46,29,17,0,17,0,1164,449,274,157,34,123,18,715,202,122,45,77,391,0,602105
14000US06037602106,140,6,37,2143,73,45,7,38,22,16,0,28,0,16,16,0,12,2070,684,364,320,183,137,0,1386,390,255,105,150,741,0,602106
14000US06037602200,140,6,37,2529,112,112,60,52,14,38,0,0,0,0,0,0,0,2417,934,798,136,76,60,0,1483,387,283,94,189,813,0,602200
14000US06037602301,140,6,37,1857,66,0,0,0,0,0,0,66,0,7,0,7,59,1791,712,560,152,19,133,0,1079,545,105,36,69,429,0,602301
14000US06037602302,140,6,37,1374,26,26,14,12,12,0,0,0,0,0,0,0,0,1348,400,275,125,62,63,0,948,507,70,40,30,371,0,602302
14000US06037602402,140,6,37,2094,138,126,34,92,42,50,0,12,12,0,0,0,0,1956,687,422,244,57,187,21,1269,408,245,59,186,616,0,602402
14000US06037602403,140,6,37,1725,212,153,69,84,0,84,0,59,17,34,0,34,8,1513,655,436,219,80,139,0,858,139,164,80,84,555,0,602403
14000US06037602404,140,6,37,1958,290,187,60,127,0,127,0,103,21,45,8,37,37,1668,754,403,351,68,283,0,914,196,207,29,178,511,0,602404
14000US06037602504,140,6,37,1705,239,101,45,56,19,37,0,138,0,0,0,0,138,1466,466,157,309,118,191,0,1000,121,152,33,119,727,0,602504
14000US06037602505,140,6,37,1617,195,168,30,138,0,138,0,27,10,0,0,0,17,1422,454,194,260,36,224,0,968,144,102,9,93,722,0,602505
14000US06037602506,140,6,37,1606,215,189,41,148,23,125,0,26,0,11,0,11,15,1391,414,188,226,71,155,0,977,249,129,9,120,599,0,602506
14000US06037602507,140,6,37,1596,214,158,88,70,24,46,0,56,0,0,0,0,56,1382,419,215,204,54,150,0,963,119,276,90,186,568,0,602507
14000US06037602508,140,6,37,2327,268,231,61,170,56,114,0,37,0,0,0,0,37,2059,789,462,327,98,229,0,1270,157,229,157,72,884,0,602508
14000US06037602509,140,6,37,1099,82,52,0,52,10,42,0,30,0,19,0,19,11,1017,445,317,128,33,95,0,572,135,165,69,96,272,0,602509
14000US06037602600,140,6,37,2842,304,207,41,166,0,166,0,97,46,0,0,0,51,2538,962,623,339,142,197,0,1576,590,247,80,167,739,0,602600
14000US06037602700,140,6,37,1097,112,74,0,74,0,74,0,38,0,16,0,16,22,985,364,172,192,71,121,0,621,263,90,21,69,268,0,602700
14000US06037602801,140,6,37,1134,230,155,75,80,36,44,0,75,11,15,0,15,49,904,426,160,266,105,161,0,478,72,127,37,90,279,0,602801
14000US06037602802,140,6,37,1253,149,149,31,118,7,111,0,0,0,0,0,0,0,1104,336,208,128,50,78,0,768,275,216,88,128,277,0,602802
14000US06037602900,140,6,37,1256,113,99,60,39,0,39,0,14,0,5,0,5,9,1143,399,280,119,44,75,0,744,214,140,48,92,390,0,602900
14000US06037603001,140,6,37,2374,213,187,57,130,0,130,0,26,0,16,0,16,10,2161,822,456,366,0,366,0,1339,331,283,85,198,725,0,603001
14000US06037603004,140,6,37,662,56,48,22,26,0,26,0,8,0,0,0,0,8,606,88,60,28,0,28,0,518,121,75,30,45,322,0,603004
14000US06037603005,140,6,37,1761,115,45,0,45,0,45,0,70,0,0,0,0,70,1646,667,217,432,20,412,18,979,166,261,108,153,552,0,603005
14000US06037603006,140,6,37,888,7,0,0,0,0,0,0,7,0,0,0,0,7,881,151,110,41,17,24,0,730,219,192,39,153,319,0,603006
14000US06037603101,140,6,37,1643,103,74,13,61,0,61,0,29,13,16,0,16,0,1540,419,222,197,116,81,0,1121,262,221,80,141,638,0,603101
14000US06037603102,140,6,37,1430,61,45,26,19,0,19,0,16,7,0,0,0,9,1369,379,224,155,0,155,0,990,428,128,42,86,434,0,603102
14000US06037603200,140,6,37,1172,12,12,0,12,0,12,0,0,0,0,0,0,0,1160,255,222,33,9,24,0,905,348,165,69,96,392,0,603200
14000US06037603301,140,6,37,1555,60,29,0,29,0,29,0,31,24,7,0,7,0,1495,290,208,82,75,7,0,1205,341,136,58,78,728,0,603301
14000US06037603302,140,6,37,1591,36,7,0,7,0,7,0,29,0,0,0,0,29,1555,369,232,137,55,82,0,1186,462,108,29,79,616,0,603302
14000US06037603400,140,6,37,1392,74,67,35,32,0,32,0,7,0,7,0,7,0,1318,370,195,175,36,139,0,948,407,116,37,79,425,0,603400
14000US06037603500,140,6,37,934,9,6,6,0,0,0,0,3,0,3,0,3,0,925,397,266,131,39,92,0,528,237,51,6,45,240,0,603500
14000US06037603600,140,6,37,1419,23,7,0,7,0,7,0,16,9,7,7,0,0,1396,375,330,36,0,36,9,1021,349,231,47,184,441,0,603600
14000US06037603702,140,6,37,1604,93,82,23,59,0,59,0,11,0,0,0,0,11,1511,423,356,67,26,41,0,1088,496,162,56,106,430,0,603702
14000US06037603703,140,6,37,832,5,0,0,0,0,0,0,5,0,0,0,0,5,827,275,232,43,24,19,0,552,327,65,44,21,160,0,603703
14000US06037603704,140,6,37,2093,223,223,173,50,28,22,0,0,0,0,0,0,0,1870,869,429,440,194,246,0,1001,151,115,12,103,735,0,603704
14000US06037603801,140,6,37,1381,132,120,37,83,13,70,0,12,0,0,0,0,12,1249,543,369,174,45,129,0,706,113,115,3,112,478,0,603801
14000US06037603802,140,6,37,1146,51,45,17,28,14,14,0,6,6,0,0,0,0,1095,592,376,216,21,195,0,503,172,124,70,54,207,0,603802
14000US06037603900,140,6,37,2318,149,80,41,39,0,39,0,69,17,42,31,11,10,2169,890,578,312,175,137,0,1279,339,250,159,91,690,0,603900
14000US06037604001,140,6,37,1263,101,101,61,40,0,40,0,0,0,0,0,0,0,1162,455,258,197,25,172,0,707,223,149,40,109,335,0,604001
14000US06037604002,140,6,37,1506,54,46,9,37,0,37,0,8,8,0,0,0,0,1452,676,355,309,167,142,12,776,240,99,50,49,437,0,604002
14000US06037604100,140,6,37,1998,191,71,29,42,0,42,0,120,81,11,11,0,28,1807,968,682,280,89,191,6,839,332,169,33,136,338,0,604100
14000US06037609900,140,6,37,651,0,0,0,0,0,0,0,0,0,0,0,0,0,651,225,165,60,32,28,0,426,123,95,3,92,208,0,609900
14000US06037620001,140,6,37,1481,69,32,26,0,0,0,6,37,9,0,0,0,28,1412,423,370,53,10,43,0,989,365,91,37,54,533,0,620001
14000US06037620002,140,6,37,1507,8,8,0,8,8,0,0,0,0,0,0,0,0,1499,548,308,240,115,125,0,951,297,83,34,49,571,0,620002
14000US06037620101,140,6,37,2152,16,16,0,16,0,16,0,0,0,0,0,0,0,2136,738,507,231,57,174,0,1398,609,166,93,73,623,0,620101
14000US06037620102,140,6,37,1605,16,8,0,8,0,8,0,8,0,0,0,0,8,1589,469,383,57,24,33,29,1120,204,94,25,69,822,0,620102
14000US06037620201,140,6,37,788,0,0,0,0,0,0,0,0,0,0,0,0,0,788,68,42,26,0,26,0,720,83,11,11,0,626,0,620201
14000US06037620301,140,6,37,1745,9,9,9,0,0,0,0,0,0,0,0,0,0,1736,791,758,20,8,12,13,945,543,105,43,62,297,0,620301
14000US06037620303,140,6,37,1684,6,6,6,0,0,0,0,0,0,0,0,0,0,1678,631,527,104,30,74,0,1047,479,68,17,51,500,0,620303
14000US06037620305,140,6,37,2731,0,0,0,0,0,0,0,0,0,0,0,0,0,2731,569,509,51,51,0,9,2162,586,50,17,33,1526,0,620305
14000US06037620400,140,6,37,2140,23,23,0,23,0,23,0,0,0,0,0,0,0,2117,651,484,167,59,108,0,1466,666,116,64,52,684,0,620400
14000US06037620501,140,6,37,2108,18,18,18,0,0,0,0,0,0,0,0,0,0,2090,773,546,213,75,138,14,1317,473,213,90,123,631,0,620501
14000US06037620521,140,6,37,1614,78,60,29,31,0,31,0,18,9,9,0,9,0,1536,601,373,228,92,136,0,935,267,76,45,31,592,0,620521
14000US06037620522,140,6,37,1819,32,8,8,0,0,0,0,24,0,0,0,0,24,1787,487,341,134,73,61,12,1300,544,102,46,56,654,0,620522
14000US06037620601,140,6,37,2348,130,101,0,101,47,54,0,29,0,17,0,17,12,2218,692,560,132,31,101,0,1526,707,69,0,69,750,0,620601
14000US06037620602,140,6,37,2059,31,15,0,15,0,15,0,16,0,16,0,16,0,2028,777,626,151,62,89,0,1251,578,71,30,41,602,0,620602
14000US06037620701,140,6,37,2783,0,0,0,0,0,0,0,0,0,0,0,0,0,2783,785,674,111,0,111,0,1998,576,344,203,141,1078,0,620701
14000US06037620702,140,6,37,2541,72,72,0,72,0,72,0,0,0,0,0,0,0,2469,683,576,107,30,77,0,1786,788,292,23,269,706,0,620702
14000US06037620800,140,6,37,2871,26,0,0,0,0,0,0,26,0,0,0,0,26,2845,1061,887,174,57,117,0,1784,993,135,31,104,656,0,620800
14000US06037620901,140,6,37,974,4,0,0,0,0,0,0,4,4,0,0,0,0,970,330,313,17,17,0,0,640,308,58,16,42,274,0,620901
14000US06037620904,140,6,37,1127,0,0,0,0,0,0,0,0,0,0,0,0,0,1127,270,244,26,9,17,0,857,270,25,0,25,562,0,620904
14000US06037621001,140,6,37,2059,8,0,0,0,0,0,0,8,0,0,0,0,8,2051,438,378,60,0,60,0,1613,474,119,62,57,1020,0,621001
14000US06037621002,140,6,37,505,58,0,0,0,0,0,0,58,0,0,0,0,58,447,97,91,6,0,6,0,350,141,7,7,0,202,0,621002
14000US06037621004,140,6,37,2317,0,0,0,0,0,0,0,0,0,0,0,0,0,2317,430,385,45,32,13,0,1887,386,70,37,33,1431,0,621004
14000US06037621102,140,6,37,1275,0,0,0,0,0,0,0,0,0,0,0,0,0,1275,401,326,75,61,14,0,874,235,51,30,21,588,0,621102
14000US06037621104,140,6,37,3136,0,0,0,0,0,0,0,0,0,0,0,0,0,3136,452,384,57,26,31,11,2684,440,101,32,69,2143,0,621104
14000US06037621201,140,6,37,2640,14,14,0,14,0,14,0,0,0,0,0,0,0,2626,816,545,271,135,136,0,1810,745,256,122,134,809,0,621201
14000US06037621204,140,6,37,1799,17,0,0,0,0,0,0,17,0,0,0,0,17,1782,84,84,0,0,0,0,1698,401,55,46,9,1242,0,621204
14000US06037621301,140,6,37,3049,63,0,0,0,0,0,0,63,36,11,0,11,16,2986,815,577,238,98,140,0,2171,819,69,31,38,1283,0,621301
14000US06037621324,140,6,37,1932,15,0,0,0,0,0,0,15,0,0,0,0,15,1917,390,360,30,17,13,0,1527,357,116,86,30,1054,0,621324
14000US06037621326,140,6,37,1869,38,8,8,0,0,0,0,30,0,0,0,0,30,1831,198,161,29,9,20,8,1633,369,71,55,16,1193,0,621326
14000US06037621400,140,6,37,1892,53,53,0,53,0,53,0,0,0,0,0,0,0,1839,543,457,86,20,66,0,1296,479,52,0,52,765,0,621400
14000US06037650001,140,6,37,2132,15,0,0,0,0,0,0,15,0,0,0,0,15,2117,595,490,105,30,75,0,1522,629,204,86,118,689,0,650001
14000US06037650003,140,6,37,1095,36,29,9,20,12,8,0,7,0,7,7,0,0,1059,358,215,143,38,105,0,701,181,136,19,117,384,0,650003
14000US06037650004,140,6,37,1577,151,81,53,28,0,28,0,70,0,41,41,0,29,1426,408,318,90,22,68,0,1018,295,208,70,138,515,0,650004
14000US06037650101,140,6,37,2088,0,0,0,0,0,0,0,0,0,0,0,0,0,2088,549,488,61,24,37,0,1539,858,231,13,218,450,0,650101
14000US06037650102,140,6,37,788,18,0,0,0,0,0,0,18,0,7,0,7,11,770,265,142,123,53,70,0,505,279,103,43,60,123,0,650102
14000US06037650200,140,6,37,1889,64,29,8,21,0,21,0,35,0,10,0,10,25,1825,682,564,118,31,87,0,1143,683,146,45,101,314,0,650200
14000US06037650300,140,6,37,2499,67,9,9,0,0,0,0,58,0,43,29,14,15,2432,665,496,169,64,105,0,1767,643,336,90,246,788,0,650300
14000US06037650401,140,6,37,1445,18,10,4,6,0,6,0,8,8,0,0,0,0,1427,542,491,51,13,38,0,885,481,93,9,84,311,0,650401
14000US06037650501,140,6,37,1083,11,11,11,0,0,0,0,0,0,0,0,0,0,1072,433,390,43,36,7,0,639,348,115,41,74,176,0,650501
14000US06037650502,140,6,37,1544,0,0,0,0,0,0,0,0,0,0,0,0,0,1544,585,476,109,20,89,0,959,613,69,25,44,277,0,650502
14000US06037650602,140,6,37,3051,156,42,29,13,0,13,0,114,0,114,68,46,0,2895,1202,902,251,99,152,49,1693,433,147,43,104,1113,0,650602
14000US06037650603,140,6,37,1603,37,37,37,0,0,0,0,0,0,0,0,0,0,1566,416,359,57,0,57,0,1150,606,113,10,103,431,0,650603
14000US06037650604,140,6,37,2507,51,0,0,0,0,0,0,51,13,0,0,0,38,2456,668,429,239,63,176,0,1788,486,103,5,98,1199,0,650604
14000US06037650605,140,6,37,1144,60,46,46,0,0,0,0,14,0,14,0,14,0,1084,348,238,110,16,94,0,736,227,106,62,44,403,0,650605
14000US06037650701,140,6,37,905,0,0,0,0,0,0,0,0,0,0,0,0,0,905,291,285,6,0,6,0,614,331,48,7,41,235,0,650701
14000US06037650702,140,6,37,1586,5,5,0,5,0,5,0,0,0,0,0,0,0,1581,707,592,88,40,48,27,874,499,112,18,94,263,0,650702
14000US06037650800,140,6,37,2910,18,18,18,0,0,0,0,0,0,0,0,0,0,2892,860,730,130,44,86,0,2032,774,269,45,224,989,0,650800
14000US06037650901,140,6,37,2427,91,78,78,0,0,0,0,13,0,0,0,0,13,2336,584,442,142,15,127,0,1752,458,351,124,227,943,0,650901
14000US06037650902,140,6,37,2635,118,106,66,40,0,40,0,12,0,0,0,0,12,2517,756,470,258,103,155,28,1761,684,200,82,118,877,0,650902
14000US06037651001,140,6,37,1877,64,0,0,0,0,0,0,64,18,11,11,0,35,1813,717,561,156,11,145,0,1096,587,115,7,108,394,0,651001
14000US06037651002,140,6,37,1715,6,0,0,0,0,0,0,6,0,0,0,0,6,1709,463,399,64,0,64,0,1246,719,133,46,87,394,0,651002
14000US06037651101,140,6,37,1938,16,16,16,0,0,0,0,0,0,0,0,0,0,1922,764,579,185,9,176,0,1158,590,90,14,76,478,0,651101
14000US06037651102,140,6,37,1725,43,43,22,21,0,21,0,0,0,0,0,0,0,1682,312,262,50,0,50,0,1370,476,163,37,126,731,0,651102
14000US06037651201,140,6,37,1709,11,0,0,0,0,0,0,11,11,0,0,0,0,1698,620,512,108,10,98,0,1078,590,57,17,40,431,0,651201
14000US06037651221,140,6,37,1306,25,17,0,9,0,9,8,8,8,0,0,0,0,1281,246,194,52,0,52,0,1035,358,46,0,46,631,0,651221
14000US06037651222,140,6,37,2361,46,46,28,18,0,18,0,0,0,0,0,0,0,2315,820,605,178,63,115,37,1495,676,175,70,105,644,0,651222
14000US06037651302,140,6,37,2437,61,51,22,29,0,29,0,10,0,10,0,10,0,2376,681,492,189,84,105,0,1695,761,164,0,164,770,0,651302
14000US06037651304,140,6,37,2308,41,13,13,0,0,0,0,28,0,0,0,0,28,2267,456,347,109,24,85,0,1811,638,45,21,24,1128,0,651304
14000US06037651401,140,6,37,1103,0,0,0,0,0,0,0,0,0,0,0,0,0,1103,94,75,19,0,19,0,1009,323,177,14,163,509,0,651401
14000US06037651402,140,6,37,2397,0,0,0,0,0,0,0,0,0,0,0,0,0,2397,854,698,156,37,119,0,1543,746,131,30,101,666,0,651402
14000US06037670001,140,6,37,1232,30,14,14,0,0,0,0,16,0,0,0,0,16,1202,358,329,29,0,29,0,844,394,61,14,47,389,0,670001
14000US06037670002,140,6,37,1452,44,28,4,24,0,24,0,16,0,0,0,0,16,1408,610,381,229,52,177,0,798,213,137,76,61,448,0,670002
14000US06037670003,140,6,37,2203,42,19,0,19,0,19,0,23,11,12,12,0,0,2161,556,362,194,92,102,0,1605,535,158,65,93,912,0,670003
14000US06037670100,140,6,37,2831,51,14,0,14,0,14,0,37,0,0,0,0,37,2780,807,598,192,94,98,17,1973,697,235,75,160,1041,0,670100
14000US06037670201,140,6,37,1569,14,5,0,5,0,5,0,9,9,0,0,0,0,1555,414,360,54,10,44,0,1141,559,66,17,49,516,0,670201
14000US06037670202,140,6,37,927,6,0,0,0,0,0,0,6,0,0,0,0,6,921,398,354,44,6,38,0,523,372,33,10,23,118,0,670202
14000US06037670324,140,6,37,1921,0,0,0,0,0,0,0,0,0,0,0,0,0,1921,616,576,40,0,40,0,1305,715,87,32,55,503,0,670324
14000US06037670326,140,6,37,1321,8,8,0,0,0,0,8,0,0,0,0,0,0,1313,470,450,20,8,12,0,843,589,30,10,20,224,0,670326
14000US06037670328,140,6,37,1572,0,0,0,0,0,0,0,0,0,0,0,0,0,1572,619,566,53,5,48,0,953,723,72,49,23,158,0,670328
14000US06037670403,140,6,37,909,4,4,4,0,0,0,0,0,0,0,0,0,0,905,299,252,47,12,35,0,606,404,29,10,19,173,0,670403
14000US06037670405,140,6,37,1170,0,0,0,0,0,0,0,0,0,0,0,0,0,1170,374,269,105,6,99,0,796,413,39,10,29,344,0,670405
14000US06037670406,140,6,37,657,0,0,0,0,0,0,0,0,0,0,0,0,0,657,237,217,14,0,14,6,420,278,32,0,32,110,0,670406
14000US06037670407,140,6,37,2183,20,0,0,0,0,0,0,20,0,0,0,0,20,2163,907,657,250,0,250,0,1256,540,229,130,99,487,0,670407
14000US06037670411,140,6,37,1506,0,0,0,0,0,0,0,0,0,0,0,0,0,1506,559,498,61,12,49,0,947,536,67,38,29,344,0,670411
14000US06037670413,140,6,37,1822,25,17,17,0,0,0,0,8,0,8,0,8,0,1797,581,456,125,23,102,0,1216,696,146,52,94,374,0,670413
14000US06037670416,140,6,37,1521,42,42,32,10,0,10,0,0,0,0,0,0,0,1479,460,433,27,0,27,0,1019,657,40,27,13,322,0,670416
14000US06037670500,140,6,37,615,0,0,0,0,0,0,0,0,0,0,0,0,0,615,164,151,10,4,6,3,451,329,30,10,20,92,0,670500
14000US06037670602,140,6,37,2869,0,0,0,0,0,0,0,0,0,0,0,0,0,2869,672,672,0,0,0,0,2197,1316,105,74,31,776,0,670602
14000US06037670701,140,6,37,2500,53,0,0,0,0,0,0,53,0,0,0,0,53,2447,765,637,128,0,128,0,1682,960,163,13,150,559,0,670701
14000US06037670702,140,6,37,1960,36,36,0,36,24,12,0,0,0,0,0,0,0,1924,478,464,14,0,14,0,1446,891,124,55,69,431,0,670702
14000US06037700101,140,6,37,3098,64,0,0,0,0,0,0,64,17,0,0,0,47,3034,196,127,69,8,61,0,2838,281,241,110,131,2316,0,700101
14000US06037700102,140,6,37,2259,129,80,0,80,0,80,0,49,0,0,0,0,49,2130,83,66,17,0,17,0,2047,298,202,114,88,1547,0,700102
14000US06037700200,140,6,37,4308,77,35,0,35,0,35,0,42,0,0,0,0,42,4231,115,103,0,0,0,12,4116,392,82,0,82,3642,0,700200
14000US06037700300,140,6,37,3662,0,0,0,0,0,0,0,0,0,0,0,0,0,3662,229,14,215,43,172,0,3433,324,60,28,32,3049,0,700300
14000US06037700400,140,6,37,3138,45,8,0,8,0,8,0,37,0,0,0,0,37,3093,164,97,67,32,35,0,2929,270,175,49,126,2484,0,700400
14000US06037700501,140,6,37,2492,49,0,0,0,0,0,0,49,0,0,0,0,49,2443,62,26,36,36,0,0,2381,423,123,50,73,1835,0,700501
14000US06037700502,140,6,37,3023,14,0,0,0,0,0,0,14,0,0,0,0,14,3009,9,9,0,0,0,0,3000,278,84,42,42,2638,0,700502
14000US06037700600,140,6,37,1655,17,17,17,0,0,0,0,0,0,0,0,0,0,1638,495,459,15,0,15,21,1143,616,114,16,98,413,0,700600
14000US06037700700,140,6,37,1068,0,0,0,0,0,0,0,0,0,0,0,0,0,1068,372,305,67,67,0,0,696,436,73,33,40,187,0,700700
14000US06037700801,140,6,37,2685,54,41,0,41,0,41,0,13,0,0,0,0,13,2631,463,425,38,0,38,0,2168,658,139,62,77,1371,0,700801
14000US06037700802,140,6,37,1792,26,0,0,0,0,0,0,26,0,0,0,0,26,1766,393,191,202,21,181,0,1373,328,71,24,47,974,0,700802
14000US06037700901,140,6,37,1520,28,20,11,9,0,9,0,8,0,8,0,8,0,1492,487,414,73,0,73,0,1005,314,83,35,48,608,0,700901
14000US06037700902,140,6,37,3068,8,8,0,8,0,8,0,0,0,0,0,0,0,3060,796,537,259,89,170,0,2264,626,201,99,102,1437,0,700902
14000US06037701000,140,6,37,2733,23,12,0,12,0,12,0,11,0,0,0,0,11,2710,693,468,225,70,155,0,2017,733,132,14,118,1152,0,701000
14000US06037701100,140,6,37,26,0,0,0,0,0,0,0,0,0,0,0,0,0,26,12,0,12,12,0,0,14,10,0,0,0,4,0,701100
14000US06037701201,140,6,37,1561,0,0,0,0,0,0,0,0,0,0,0,0,0,1561,494,441,44,0,44,9,1067,594,95,37,58,378,0,701201
14000US06037701202,140,6,37,1845,29,6,0,6,0,6,0,23,0,23,12,11,0,1816,426,177,249,57,192,0,1390,323,0,0,0,1067,0,701202
14000US06037701302,140,6,37,2847,34,0,0,0,0,0,0,34,0,0,0,0,34,2813,300,187,113,0,113,0,2513,430,88,0,88,1995,0,701302
14000US06037701304,140,6,37,3329,31,0,0,0,0,0,0,31,0,0,0,0,31,3298,574,525,32,0,32,17,2724,780,147,40,107,1797,0,701304
14000US06037701402,140,6,37,4175,199,12,0,12,0,12,0,187,0,0,0,0,187,3976,255,113,142,128,14,0,3721,548,201,18,183,2972,0,701402
14000US06037701501,140,6,37,2668,13,13,0,13,13,0,0,0,0,0,0,0,0,2655,354,252,102,22,80,0,2301,539,93,71,22,1669,0,701501
14000US06037701502,140,6,37,1967,67,32,0,32,0,32,0,35,0,28,28,0,7,1900,274,191,83,10,73,0,1626,149,80,72,8,1397,0,701502
14000US06037701601,140,6,37,1892,21,0,0,0,0,0,0,21,0,0,0,0,21,1871,579,457,122,47,75,0,1292,473,75,13,62,744,0,701601
14000US06037701602,140,6,37,1966,0,0,0,0,0,0,0,0,0,0,0,0,0,1966,392,243,149,33,116,0,1574,379,51,0,51,1144,0,701602
14000US06037701701,140,6,37,1666,15,9,9,0,0,0,0,6,0,0,0,0,6,1651,259,157,102,28,74,0,1392,205,117,44,73,1070,0,701701
14000US06037701702,140,6,37,1714,16,7,0,7,0,7,0,9,0,0,0,0,9,1698,158,126,32,7,25,0,1540,235,61,21,40,1244,0,701702
14000US06037701801,140,6,37,2583,129,28,12,16,0,16,0,101,0,35,0,35,66,2454,562,265,297,27,270,0,1892,417,168,39,129,1307,0,701801
14000US06037701802,140,6,37,1840,83,40,40,0,0,0,0,43,0,0,0,0,43,1757,315,141,174,39,135,0,1442,310,163,22,141,969,0,701802
14000US06037701902,140,6,37,2527,0,0,0,0,0,0,0,0,0,0,0,0,0,2527,87,87,0,0,0,0,2440,385,51,27,24,2004,0,701902
14000US06037702002,140,6,37,3163,104,42,16,26,15,11,0,62,0,0,0,0,62,3059,450,351,99,18,81,0,2609,280,139,36,103,2190,0,702002
14000US06037702102,140,6,37,3754,119,84,67,17,17,0,0,35,0,0,0,0,35,3635,441,428,13,0,13,0,3194,386,201,76,125,2607,0,702102
14000US06037702201,140,6,37,2280,124,0,0,0,0,0,0,124,39,0,0,0,85,2156,504,387,117,28,89,0,1652,271,115,37,78,1266,0,702201
14000US06037702202,140,6,37,1684,27,4,0,4,0,4,0,23,0,0,0,0,23,1657,429,354,75,13,62,0,1228,367,124,38,86,737,0,702202
14000US06037702300,140,6,37,2978,38,0,0,0,0,0,0,38,0,0,0,0,38,2940,749,586,163,11,152,0,2191,488,240,35,205,1463,0,702300
14000US06037702400,140,6,37,1805,15,0,0,0,0,0,0,15,0,0,0,0,15,1790,360,245,115,6,109,0,1430,519,73,12,61,838,0,702400
14000US06037702501,140,6,37,2034,17,17,17,0,0,0,0,0,0,0,0,0,0,2017,528,345,183,53,130,0,1489,481,205,76,129,803,0,702501
14000US06037702502,140,6,37,2143,0,0,0,0,0,0,0,0,0,0,0,0,0,2143,370,284,86,35,51,0,1773,582,164,48,116,1027,0,702502
14000US06037702600,140,6,37,2215,43,15,0,15,0,15,0,28,15,13,0,13,0,2172,726,631,95,11,84,0,1446,681,209,79,130,556,0,702600
14000US06037702700,140,6,37,1270,0,0,0,0,0,0,0,0,0,0,0,0,0,1270,527,459,68,25,43,0,743,309,82,44,38,352,0,702700
14000US06037702801,140,6,37,2087,81,15,0,15,0,15,0,66,0,0,0,0,66,2006,609,466,143,88,55,0,1397,428,176,0,176,793,0,702801
14000US06037702802,140,6,37,835,16,16,0,16,16,0,0,0,0,0,0,0,0,819,295,210,85,55,30,0,524,133,52,27,25,339,0,702802
14000US06037702803,140,6,37,1188,35,28,9,12,0,12,7,7,0,0,0,0,7,1153,310,216,94,21,73,0,843,229,131,63,68,483,0,702803
14000US06037702901,140,6,37,5421,139,30,0,30,14,16,0,109,0,26,0,26,83,5282,427,288,139,36,103,0,4855,1155,184,12,172,3516,0,702901
14000US06037703001,140,6,37,3107,28,10,0,10,0,10,0,18,0,0,0,0,18,3079,588,347,241,20,221,0,2491,419,134,40,94,1938,0,703001
14000US06037703002,140,6,37,2977,39,18,1,0,0,0,17,21,0,21,0,21,0,2938,862,513,337,142,195,12,2076,645,289,38,251,1142,0,703002
14000US06037703100,140,6,37,2348,50,25,0,25,0,25,0,25,25,0,0,0,0,2298,501,264,237,87,150,0,1797,604,215,17,198,978,0,703100
14000US06037703200,140,6,37,2253,129,77,41,36,0,36,0,52,0,30,13,17,22,2124,558,411,147,0,147,0,1566,548,260,64,196,758,0,703200
14000US06037800101,140,6,37,2011,12,12,12,0,0,0,0,0,0,0,0,0,0,1999,643,455,175,50,125,13,1356,837,121,34,87,398,0,800101
14000US06037800102,140,6,37,2671,27,0,0,0,0,0,0,27,12,0,0,0,15,2644,1079,937,142,18,124,0,1565,703,137,72,65,725,0,800102
14000US06037800202,140,6,37,2062,0,0,0,0,0,0,0,0,0,0,0,0,0,2062,1088,873,215,42,173,0,974,614,117,43,74,243,0,800202
14000US06037800203,140,6,37,1919,44,41,10,31,0,31,0,3,0,0,0,0,3,1875,652,572,80,6,74,0,1223,629,140,103,37,454,0,800203
14000US06037800204,140,6,37,1744,0,0,0,0,0,0,0,0,0,0,0,0,0,1744,669,492,177,0,177,0,1075,666,77,0,77,332,0,800204
14000US06037800324,140,6,37,2455,14,0,0,0,0,0,0,14,0,14,0,14,0,2441,759,520,201,57,144,38,1682,1053,219,0,219,410,0,800324
14000US06037800325,140,6,37,1454,0,0,0,0,0,0,0,0,0,0,0,0,0,1454,380,294,86,22,64,0,1074,530,75,19,56,469,0,800325
14000US06037800326,140,6,37,2033,21,0,0,0,0,0,0,21,0,10,0,10,11,2012,560,450,99,31,68,11,1452,724,123,44,79,605,0,800326
14000US06037800327,140,6,37,2017,165,123,0,123,0,123,0,42,13,15,0,15,14,1852,663,272,378,18,360,13,1189,453,33,0,33,703,0,800327
14000US06037800328,140,6,37,986,0,0,0,0,0,0,0,0,0,0,0,0,0,986,348,288,60,0,60,0,638,202,79,31,48,357,0,800328
14000US06037800329,140,6,37,2540,13,13,0,13,0,13,0,0,0,0,0,0,0,2527,960,725,219,41,178,16,1567,641,109,56,53,817,0,800329
14000US06037800330,140,6,37,324,21,21,17,4,0,4,0,0,0,0,0,0,0,303,78,78,0,0,0,0,225,77,45,12,33,103,0,800330
14000US06037800331,140,6,37,275,14,14,14,0,0,0,0,0,0,0,0,0,0,261,50,50,0,0,0,0,211,87,36,0,36,88,0,800331
14000US06037800332,140,6,37,2175,11,0,0,0,0,0,0,11,0,11,0,11,0,2164,911,802,109,9,100,0,1253,945,111,54,57,197,0,800332
14000US06037800406,140,6,37,809,0,0,0,0,0,0,0,0,0,0,0,0,0,809,287,263,24,0,24,0,522,256,94,53,41,172,0,800406
14000US06037800408,140,6,37,2791,71,41,0,41,0,41,0,30,0,0,0,0,30,2720,758,593,148,14,134,17,1962,961,68,16,52,933,0,800408
14000US06037800410,140,6,37,648,0,0,0,0,0,0,0,0,0,0,0,0,0,648,217,178,39,0,39,0,431,236,10,0,10,185,0,800410
14000US06037800504,140,6,37,1034,8,0,0,0,0,0,0,8,0,8,0,8,0,1026,213,188,25,0,25,0,813,286,67,10,57,460,0,800504
14000US06037800506,140,6,37,1374,22,12,0,12,0,12,0,10,10,0,0,0,0,1352,431,305,126,26,100,0,921,448,70,33,37,403,0,800506
14000US06037900102,140,6,37,315,23,18,11,7,0,7,0,5,5,0,0,0,0,292,50,37,13,0,13,0,242,60,84,29,55,98,0,900102
14000US06037900103,140,6,37,1622,185,136,74,62,0,62,0,49,0,34,14,20,15,1437,670,568,102,32,70,0,767,393,131,57,74,243,0,900103
14000US06037900104,140,6,37,1689,251,209,47,162,52,110,0,42,8,25,5,20,9,1438,541,302,239,105,134,0,897,333,193,15,178,371,0,900104
14000US06037900201,140,6,37,385,19,9,0,9,0,9,0,10,5,0,0,0,5,366,155,127,28,9,19,0,211,93,0,0,0,118,0,900201
14000US06037900300,140,6,37,1167,29,29,11,18,0,18,0,0,0,0,0,0,0,1138,434,314,120,78,42,0,704,211,94,35,59,399,0,900300
14000US06037900501,140,6,37,1887,218,177,61,100,35,65,16,41,8,33,11,22,0,1669,762,437,318,63,255,7,907,439,126,41,85,342,0,900501
14000US06037900504,140,6,37,1701,117,95,28,67,9,58,0,22,6,16,0,16,0,1584,741,483,258,84,174,0,843,374,211,38,173,258,0,900504
14000US06037900505,140,6,37,1170,125,90,10,80,9,71,0,35,8,27,0,27,0,1045,513,302,211,11,200,0,532,194,61,0,61,277,0,900505
14000US06037900506,140,6,37,1310,143,143,35,97,0,97,11,0,0,0,0,0,0,1167,603,358,245,44,201,0,564,245,128,88,40,191,0,900506
14000US06037900507,140,6,37,2267,277,169,51,118,50,68,0,108,16,79,55,24,13,1990,999,709,290,77,213,0,991,388,103,26,77,500,0,900507
14000US06037900508,140,6,37,1032,86,78,52,26,0,26,0,8,0,0,0,0,8,946,437,365,72,2,70,0,509,231,25,0,25,253,0,900508
14000US06037900602,140,6,37,1627,235,175,50,125,0,125,0,60,10,16,0,16,34,1392,591,442,149,12,137,0,801,182,99,24,75,520,0,900602
14000US06037900605,140,6,37,2264,188,175,63,112,0,112,0,13,13,0,0,0,0,2076,835,500,320,79,241,15,1241,546,167,26,141,528,0,900605
14000US06037900606,140,6,37,1165,254,214,78,136,11,125,0,40,10,13,0,13,17,911,370,191,179,7,172,0,541,231,86,16,70,224,0,900606
14000US06037900607,140,6,37,1138,201,153,66,87,33,54,0,48,0,22,9,13,26,937,479,215,264,60,204,0,458,231,49,31,18,178,0,900607
14000US06037900608,140,6,37,967,128,109,51,58,18,40,0,19,0,0,0,0,19,839,437,300,137,38,99,0,402,186,50,37,13,166,0,900608
14000US06037900609,140,6,37,1555,223,198,28,170,0,170,0,25,4,21,0,21,0,1332,574,362,212,7,205,0,758,417,43,33,10,298,0,900609
14000US06037900701,140,6,37,1604,302,193,40,153,26,127,0,109,19,54,0,54,36,1302,454,310,144,51,93,0,848,254,202,52,150,392,0,900701
14000US06037900703,140,6,37,1662,225,123,36,87,13,74,0,102,0,8,0,8,94,1437,351,173,145,33,112,33,1086,170,77,14,63,839,0,900703
14000US06037900704,140,6,37,1346,193,139,32,107,38,69,0,54,10,0,0,0,44,1153,307,95,193,54,139,19,846,107,90,0,90,649,0,900704
14000US06037900705,140,6,37,2011,238,158,56,91,0,91,11,80,12,0,0,0,68,1773,579,243,336,126,210,0,1194,341,121,82,39,732,0,900705
14000US06037900803,140,6,37,2573,331,255,60,195,25,170,0,76,32,44,0,44,0,2242,1122,922,200,34,166,0,1120,543,174,60,114,403,0,900803
14000US06037900804,140,6,37,1007,208,144,92,52,12,40,0,64,35,6,6,0,23,799,316,215,101,29,72,0,483,160,121,26,95,202,0,900804
14000US06037900805,140,6,37,1408,140,112,11,101,0,101,0,28,0,11,0,11,17,1268,390,223,167,98,69,0,878,390,196,39,157,292,0,900805
14000US06037900806,140,6,37,1884,259,155,31,124,0,124,0,104,9,62,0,62,33,1625,149,67,82,10,72,0,1476,117,122,69,53,1237,0,900806
14000US06037900900,140,6,37,1337,81,63,23,40,36,4,0,18,0,8,0,8,10,1256,365,334,31,20,11,0,891,449,20,0,20,422,0,900900
14000US06037901003,140,6,37,0,0,0,0,0,0,0,0,0,0,0,0,0,0,0,0,0,0,0,0,0,0,0,0,0,0,0,0,901003
14000US06037901004,140,6,37,3585,164,111,48,63,0,63,0,53,53,0,0,0,0,3421,1437,1156,281,93,188,0,1984,927,219,20,199,838,0,901004
14000US06037901007,140,6,37,676,8,0,0,0,0,0,0,8,0,8,8,0,0,668,165,165,0,0,0,0,503,327,52,19,33,124,0,901007
14000US06037901008,140,6,37,984,20,15,6,9,9,0,0,5,5,0,0,0,0,964,308,188,120,17,103,0,656,290,115,37,78,251,0,901008
14000US06037901009,140,6,37,1892,79,60,12,48,9,39,0,19,0,10,0,10,9,1813,579,407,172,95,77,0,1234,634,89,59,30,511,0,901009
14000US06037901010,140,6,37,1970,120,111,73,38,18,20,0,9,9,0,0,0,0,1850,627,407,210,129,81,10,1223,603,108,28,80,512,0,901010
14000US06037901011,140,6,37,1991,155,110,50,60,0,60,0,45,35,0,0,0,10,1836,572,364,208,97,111,0,1264,455,165,75,90,644,0,901011
14000US06037901101,140,6,37,1755,106,86,8,78,21,57,0,20,0,10,0,10,10,1649,707,461,246,24,222,0,942,364,141,53,88,437,0,901101
14000US06037901102,140,6,37,1801,117,99,51,19,0,19,29,18,9,0,0,0,9,1684,755,403,352,97,255,0,929,491,86,10,76,352,0,901102
14000US06037901205,140,6,37,3603,82,82,43,39,15,24,0,0,0,0,0,0,0,3521,1313,1109,204,10,194,0,2208,1027,174,108,66,1007,0,901205
14000US06037901209,140,6,37,506,11,5,5,0,0,0,0,6,0,0,0,0,6,495,94,82,12,12,0,0,401,162,61,16,45,178,0,901209
14000US06037901210,140,6,37,574,19,14,0,14,0,14,0,5,0,0,0,0,5,555,145,119,26,16,10,0,410,190,36,19,17,184,0,901210
14000US06037901213,140,6,37,1287,8,8,8,0,0,0,0,0,0,0,0,0,0,1279,443,366,61,33,28,16,836,505,68,39,29,263,0,901213
14000US06037910001,140,6,37,1393,188,94,49,45,34,11,0,94,14,31,0,31,49,1205,764,557,207,46,161,0,441,240,97,29,68,104,0,910001
14000US06037910002,140,6,37,1960,171,98,59,39,0,39,0,73,43,15,0,15,15,1789,591,429,162,113,49,0,1198,449,263,123,140,486,0,910002
14000US06037910101,140,6,37,392,100,66,39,27,0,27,0,34,0,0,0,0,34,292,154,86,68,13,55,0,138,49,7,0,7,82,0,910101
14000US06037910201,140,6,37,1160,116,106,43,63,17,46,0,10,0,0,0,0,10,1044,381,272,109,31,78,0,663,241,143,47,96,279,0,910201
14000US06037910202,140,6,37,1736,54,26,10,16,0,16,0,28,15,4,0,4,9,1682,724,553,171,72,99,0,958,675,73,30,43,210,0,910202
14000US06037910205,140,6,37,438,34,26,23,3,0,3,0,8,8,0,0,0,0,404,93,90,3,0,3,0,311,178,37,9,28,96,0,910205
14000US06037910206,140,6,37,973,27,27,0,27,6,21,0,0,0,0,0,0,0,946,538,412,121,83,38,5,408,235,28,28,0,145,0,910206
14000US06037910207,140,6,37,1674,36,11,11,0,0,0,0,25,25,0,0,0,0,1638,802,607,195,71,124,0,836,473,77,0,77,286,0,910207
14000US06037910208,140,6,37,1801,190,144,64,80,0,80,0,46,18,28,0,28,0,1611,782,672,94,51,43,16,829,481,106,64,42,242,0,910208
14000US06037910209,140,6,37,1278,0,0,0,0,0,0,0,0,0,0,0,0,0,1278,571,460,111,20,91,0,707,414,54,0,54,239,0,910209
14000US06037910210,140,6,37,2068,61,61,37,24,0,24,0,0,0,0,0,0,0,2007,1002,893,109,33,76,0,1005,607,103,23,80,295,0,910210
14000US06037910301,140,6,37,1420,62,23,11,12,0,12,0,39,8,0,0,0,31,1358,470,358,86,11,75,26,888,536,82,20,62,270,0,910301
14000US06037910302,140,6,37,1953,128,93,15,78,50,28,0,35,11,10,0,10,14,1825,603,493,110,63,47,0,1222,701,182,62,120,339,0,910302
14000US06037910401,140,6,37,2186,143,126,114,12,0,12,0,17,0,0,0,0,17,2043,691,499,157,33,124,35,1352,575,110,43,67,667,0,910401
14000US06037910402,140,6,37,878,309,275,105,170,4,166,0,34,6,28,0,28,0,569,284,119,165,35,130,0,285,106,55,28,27,124,0,910402
14000US06037910403,140,6,37,610,178,178,49,129,18,111,0,0,0,0,0,0,0,432,214,117,97,36,61,0,218,71,93,49,44,54,0,910403
14000US06037910404,140,6,37,931,141,113,91,22,10,12,0,28,14,14,0,14,0,790,454,232,185,75,110,37,336,212,55,26,29,69,0,910404
14000US06037910501,140,6,37,1831,671,618,86,532,76,456,0,53,0,7,0,7,46,1160,483,180,303,23,280,0,677,58,104,23,81,515,0,910501
14000US06037910502,140,6,37,1085,399,327,66,261,29,232,0,72,26,22,22,0,24,686,313,177,136,77,59,0,373,123,52,45,7,198,0,910502
14000US06037910504,140,6,37,1201,479,389,116,246,108,138,27,90,22,24,16,8,44,722,456,305,151,39,112,0,266,167,25,12,13,74,0,910504
14000US06037910505,140,6,37,692,97,49,19,30,0,30,0,48,39,9,9,0,0,595,335,263,72,36,36,0,260,145,29,11,18,86,0,910505
14000US06037910601,140,6,37,1582,244,211,107,104,17,87,0,33,15,4,0,4,14,1338,728,466,245,69,176,17,610,222,125,16,109,263,0,910601
14000US06037910602,140,6,37,1278,176,118,21,97,0,97,0,58,0,9,0,9,49,1102,398,227,155,93,62,16,704,182,141,110,31,381,0,910602
14000US06037910603,140,6,37,1878,329,299,49,225,16,209,25,30,0,11,0,11,19,1549,753,571,182,50,132,0,796,228,129,52,77,439,0,910603
14000US06037910605,140,6,37,1210,153,146,70,76,0,76,0,7,7,0,0,0,0,1057,611,446,165,45,120,0,446,239,72,0,72,135,0,910605
14000US06037910606,140,6,37,696,103,98,58,40,0,40,0,5,0,5,0,5,0,593,322,178,139,66,73,5,271,107,64,40,24,100,0,910606
14000US06037910705,140,6,37,2788,236,138,105,33,0,33,0,98,24,38,0,38,36,2552,1544,1141,389,118,271,14,1008,464,257,115,142,287,0,910705
14000US06037910706,140,6,37,1345,150,133,73,60,16,44,0,17,9,8,0,8,0,1195,725,479,239,113,126,7,470,237,107,74,33,126,0,910706
14000US06037910707,140,6,37,1328,177,134,11,123,12,111,0,43,0,8,8,0,35,1151,493,302,191,89,102,0,658,254,122,45,77,282,0,910707
14000US06037910709,140,6,37,492,39,39,39,0,0,0,0,0,0,0,0,0,0,453,170,116,54,0,54,0,283,174,19,4,15,90,0,910709
14000US06037910711,140,6,37,2193,411,398,83,315,11,304,0,13,0,0,0,0,13,1782,830,381,371,71,300,78,952,335,173,42,131,444,0,910711
14000US06037910712,140,6,37,660,50,50,15,35,13,22,0,0,0,0,0,0,0,610,220,185,35,16,19,0,390,301,0,0,0,89,0,910712
14000US06037910713,140,6,37,1289,247,235,151,84,14,70,0,12,0,12,0,12,0,1042,684,534,143,57,86,7,358,174,61,40,21,123,0,910713
14000US06037910714,140,6,37,841,176,176,35,141,48,93,0,0,0,0,0,0,0,665,424,253,171,53,118,0,241,77,69,9,60,95,0,910714
14000US06037910715,140,6,37,1657,187,96,4,92,0,92,0,91,8,47,0,47,36,1470,838,607,231,14,217,0,632,283,101,52,49,248,0,910715
14000US06037910716,140,6,37,1591,121,107,88,19,0,19,0,14,0,0,0,0,14,1470,706,517,189,33,156,0,764,444,102,46,56,218,0,910716
14000US06037910804,140,6,37,1025,0,0,0,0,0,0,0,0,0,0,0,0,0,1025,301,264,37,0,37,0,724,425,119,29,90,180,0,910804
14000US06037910805,140,6,37,1540,48,48,0,48,40,8,0,0,0,0,0,0,0,1492,381,296,85,20,65,0,1111,731,34,8,26,346,0,910805
14000US06037910807,140,6,37,1840,73,58,7,51,0,51,0,15,15,0,0,0,0,1767,821,619,202,29,173,0,946,491,124,43,81,331,0,910807
14000US06037910808,140,6,37,1147,0,0,0,0,0,0,0,0,0,0,0,0,0,1147,473,354,119,69,50,0,674,354,93,11,82,227,0,910808
14000US06037910809,140,6,37,712,11,11,11,0,0,0,0,0,0,0,0,0,0,701,271,197,74,18,56,0,430,300,20,17,3,110,0,910809
14000US06037910810,140,6,37,821,24,24,0,24,0,24,0,0,0,0,0,0,0,797,390,365,25,0,25,0,407,255,34,23,11,118,0,910810
14000US06037910811,140,6,37,76,0,0,0,0,0,0,0,0,0,0,0,0,0,76,13,13,0,0,0,0,63,28,0,0,0,35,0,910811
14000US06037910812,140,6,37,170,5,5,0,5,0,5,0,0,0,0,0,0,0,165,55,43,12,12,0,0,110,59,5,5,0,46,0,910812
14000US06037910813,140,6,37,1161,44,36,36,0,0,0,0,8,0,0,0,0,8,1117,336,285,51,0,51,0,781,534,11,11,0,236,0,910813
14000US06037911001,140,6,37,1575,40,18,13,5,0,5,0,22,22,0,0,0,0,1535,220,148,72,23,49,0,1315,766,152,80,72,397,0,911001
14000US06037920011,140,6,37,79,0,0,0,0,0,0,0,0,0,0,0,0,0,79,3,3,0,0,0,0,76,10,22,18,4,44,0,920011
14000US06037920012,140,6,37,477,16,0,0,0,0,0,0,16,0,16,16,0,0,461,84,58,23,11,12,3,377,138,33,30,3,206,0,920012
14000US06037920013,140,6,37,1422,30,10,10,0,0,0,0,20,0,0,0,0,20,1392,513,437,76,55,21,0,879,453,163,28,135,263,0,920013
14000US06037920015,140,6,37,1912,37,37,0,37,0,37,0,0,0,0,0,0,0,1875,1024,875,149,70,79,0,851,510,116,25,91,225,0,920015
14000US06037920016,140,6,37,1515,20,10,10,0,0,0,0,10,10,0,0,0,0,1495,787,692,95,9,86,0,708,478,65,14,51,165,0,920016
14000US06037920017,140,6,37,1412,89,58,41,17,0,17,0,31,23,8,0,8,0,1323,549,461,88,45,43,0,774,405,125,61,64,244,0,920017
14000US06037920018,140,6,37,777,22,22,8,14,0,14,0,0,0,0,0,0,0,755,282,158,124,19,105,0,473,271,32,17,15,170,0,920018
14000US06037920020,140,6,37,2137,40,14,14,0,0,0,0,26,9,0,0,0,17,2097,982,825,157,21,136,0,1115,721,95,39,56,299,0,920020
14000US06037920023,140,6,37,742,59,41,17,24,24,0,0,18,0,18,7,11,0,683,251,131,120,80,40,0,432,160,118,9,109,154,0,920023
14000US06037920026,140,6,37,98,0,0,0,0,0,0,0,0,0,0,0,0,0,98,43,39,4,0,4,0,55,36,0,0,0,19,0,920026
14000US06037920028,140,6,37,1833,79,65,34,31,0,31,0,14,14,0,0,0,0,1754,1025,846,168,22,146,11,729,357,127,30,97,245,0,920028
14000US06037920029,140,6,37,1168,7,7,7,0,0,0,0,0,0,0,0,0,0,1161,452,340,104,55,49,8,709,226,116,19,97,367,0,920029
14000US06037920030,140,6,37,1863,41,20,7,13,0,13,0,21,0,21,5,16,0,1822,703,465,238,60,178,0,1119,478,212,97,115,429,0,920030
14000US06037920031,140,6,37,2576,30,13,0,13,0,13,0,17,0,17,0,17,0,2546,280,214,66,0,66,0,2266,912,260,136,124,1094,0,920031
14000US06037920032,140,6,37,808,0,0,0,0,0,0,0,0,0,0,0,0,0,808,483,436,47,9,38,0,325,249,12,12,0,64,0,920032
14000US06037920033,140,6,37,194,8,4,4,0,0,0,0,4,0,0,0,0,4,186,51,33,18,13,5,0,135,87,25,0,25,23,0,920033
14000US06037920034,140,6,37,1145,63,43,22,21,21,0,0,20,0,20,0,20,0,1082,424,262,162,89,73,0,658,314,85,53,32,259,0,920034
14000US06037920035,140,6,37,2283,85,85,41,44,0,44,0,0,0,0,0,0,0,2198,1082,669,337,155,182,76,1116,443,301,194,107,372,0,920035
14000US06037920036,140,6,37,950,46,37,13,24,0,24,0,9,5,4,0,4,0,904,357,250,107,29,78,0,547,307,138,93,45,102,0,920036
14000US06037920037,140,6,37,2162,409,344,39,305,160,145,0,65,5,11,11,0,49,1753,639,287,352,165,187,0,1114,332,187,74,113,595,0,920037
14000US06037920038,140,6,37,1596,253,161,0,161,0,161,0,92,28,7,7,0,57,1343,456,243,213,33,180,0,887,221,129,15,114,537,0,920038
14000US06037920039,140,6,37,593,27,10,10,0,0,0,0,17,0,17,0,17,0,566,202,182,20,11,9,0,364,242,55,35,20,67,0,920039
14000US06037920040,140,6,37,991,14,14,11,3,3,0,0,0,0,0,0,0,0,977,459,343,116,0,116,0,518,235,145,75,70,138,0,920040
14000US06037920041,140,6,37,908,21,21,3,14,5,9,4,0,0,0,0,0,0,887,410,252,158,51,107,0,477,175,111,36,75,191,0,920041
14000US06037920042,140,6,37,2697,164,136,47,89,0,89,0,28,12,0,0,0,16,2533,741,431,286,0,286,24,1792,602,207,139,68,983,0,920042
14000US06037920043,140,6,37,1715,46,46,8,38,0,38,0,0,0,0,0,0,0,1669,907,755,152,45,107,0,762,471,66,22,44,225,0,920043
14000US06037920044,140,6,37,959,0,0,0,0,0,0,0,0,0,0,0,0,0,959,393,377,16,3,13,0,566,377,93,0,93,96,0,920044
14000US06037920045,140,6,37,1473,51,38,21,17,0,17,0,13,0,0,0,0,13,1422,676,593,83,74,9,0,746,568,93,33,60,85,0,920045
14000US06037920102,140,6,37,1877,125,125,89,36,0,36,0,0,0,0,0,0,0,1752,688,516,172,81,91,0,1064,407,58,22,36,599,0,920102
14000US06037920104,140,6,37,902,10,5,5,0,0,0,0,5,0,0,0,0,5,892,413,296,88,27,61,29,479,236,63,24,39,180,0,920104
14000US06037920106,140,6,37,835,84,58,43,15,5,10,0,26,5,0,0,0,21,751,322,211,111,4,107,0,429,218,52,14,38,159,0,920106
14000US06037920107,140,6,37,1179,16,8,8,0,0,0,0,8,0,8,8,0,0,1163,839,808,31,17,14,0,324,243,20,15,5,61,0,920107
14000US06037920108,140,6,37,1342,0,0,0,0,0,0,0,0,0,0,0,0,0,1342,614,518,87,14,73,9,728,271,37,11,26,420,0,920108
14000US06037920109,140,6,37,1602,0,0,0,0,0,0,0,0,0,0,0,0,0,1602,582,463,119,10,109,0,1020,496,85,31,54,439,0,920109
14000US06037920110,140,6,37,1529,41,9,0,9,9,0,0,32,0,0,0,0,32,1488,788,657,131,37,94,0,700,441,23,17,6,236,0,920110
14000US06037920111,140,6,37,1027,35,11,11,0,0,0,0,24,0,6,0,6,18,992,371,272,99,22,77,0,621,397,16,0,16,208,0,920111
14000US06037920112,140,6,37,1537,46,19,19,0,0,0,0,27,0,0,0,0,27,1491,385,327,58,34,24,0,1106,538,71,17,54,497,0,920112
14000US06037920114,140,6,37,2287,49,49,0,49,0,49,0,0,0,0,0,0,0,2238,1030,787,243,92,151,0,1208,620,37,14,23,551,0,920114
14000US06037920115,140,6,37,1372,30,23,0,23,0,23,0,7,7,0,0,0,0,1342,494,348,146,27,119,0,848,357,88,45,43,403,0,920115
14000US06037920116,140,6,37,1591,0,0,0,0,0,0,0,0,0,0,0,0,0,1591,692,529,163,20,143,0,899,562,123,53,70,214,0,920116
14000US06037920118,140,6,37,1810,0,0,0,0,0,0,0,0,0,0,0,0,0,1810,1041,794,247,145,102,0,769,371,44,14,30,354,0,920118
14000US06037920119,140,6,37,474,5,5,5,0,0,0,0,0,0,0,0,0,0,469,315,312,3,0,3,0,154,111,14,12,2,29,0,920119
14000US06037920200,140,6,37,0,0,0,0,0,0,0,0,0,0,0,0,0,0,0,0,0,0,0,0,0,0,0,0,0,0,0,0,920200
14000US06037920303,140,6,37,524,8,0,0,0,0,0,0,8,0,2,0,2,6,516,123,101,22,0,22,0,393,132,5,0,5,256,0,920303
14000US06037920312,140,6,37,1907,87,35,28,7,0,7,0,52,15,0,0,0,37,1820,620,389,231,94,137,0,1200,619,75,28,47,506,0,920312
14000US06037920313,140,6,37,1844,56,37,19,18,0,18,0,19,0,12,0,12,7,1788,702,591,105,51,54,6,1086,578,132,74,58,376,0,920313
14000US06037920314,140,6,37,939,0,0,0,0,0,0,0,0,0,0,0,0,0,939,382,339,43,0,43,0,557,325,38,8,30,194,0,920314
14000US06037920322,140,6,37,1098,0,0,0,0,0,0,0,0,0,0,0,0,0,1098,360,265,95,16,79,0,738,435,52,6,46,251,0,920322
14000US06037920326,140,6,37,2458,8,0,0,0,0,0,0,8,0,0,0,0,8,2450,888,663,187,40,147,38,1562,528,128,42,86,906,0,920326
14000US06037920328,140,6,37,790,0,0,0,0,0,0,0,0,0,0,0,0,0,790,193,180,13,0,13,0,597,251,25,19,6,321,0,920328
14000US06037920329,140,6,37,2202,32,32,0,32,0,32,0,0,0,0,0,0,0,2170,833,591,195,63,132,47,1337,514,130,16,114,693,0,920329
14000US06037920330,140,6,37,2325,37,8,8,0,0,0,0,29,0,29,29,0,0,2288,432,373,59,0,59,0,1856,564,229,118,111,1063,0,920330
14000US06037920331,140,6,37,1479,10,0,0,0,0,0,0,10,10,0,0,0,0,1469,509,367,116,56,60,26,960,455,41,8,33,464,0,920331
14000US06037920332,140,6,37,658,5,5,0,5,0,5,0,0,0,0,0,0,0,653,203,140,63,22,41,0,450,179,46,14,32,225,0,920332
14000US06037920334,140,6,37,2272,35,16,0,16,0,16,0,19,19,0,0,0,0,2237,775,482,293,0,293,0,1462,602,181,39,142,679,0,920334
14000US06037920336,140,6,37,1712,237,229,146,83,25,58,0,8,0,0,0,0,8,1475,632,435,197,52,145,0,843,396,135,86,49,312,0,920336
14000US06037920337,140,6,37,1872,194,185,70,115,8,107,0,9,0,9,0,9,0,1678,1062,540,496,191,305,26,616,157,154,61,93,305,0,920337
14000US06037920338,140,6,37,1757,13,13,0,13,0,13,0,0,0,0,0,0,0,1744,1015,869,134,64,70,12,729,430,83,48,35,216,0,920338
14000US06037920339,140,6,37,2180,0,0,0,0,0,0,0,0,0,0,0,0,0,2180,1359,1097,262,163,99,0,821,471,44,16,28,306,0,920339
14000US06037930101,140,6,37,62,0,0,0,0,0,0,0,0,0,0,0,0,0,62,26,26,0,0,0,0,36,16,0,0,0,20,0,930101
14000US06037930200,140,6,37,186,29,29,29,0,0,0,0,0,0,0,0,0,0,157,19,10,9,9,0,0,138,70,9,0,9,59,0,930200
14000US06037930301,140,6,37,292,19,9,0,9,9,0,0,10,10,0,0,0,0,273,49,38,11,11,0,0,224,118,23,9,14,83,0,930301
14000US06037980001,140,6,37,0,0,0,0,0,0,0,0,0,0,0,0,0,0,0,0,0,0,0,0,0,0,0,0,0,0,0,0,980001
14000US06037980002,140,6,37,0,0,0,0,0,0,0,0,0,0,0,0,0,0,0,0,0,0,0,0,0,0,0,0,0,0,0,0,980002
14000US06037980003,140,6,37,0,0,0,0,0,0,0,0,0,0,0,0,0,0,0,0,0,0,0,0,0,0,0,0,0,0,0,0,980003
14000US06037980004,140,6,37,15,0,0,0,0,0,0,0,0,0,0,0,0,0,15,3,3,0,0,0,0,12,0,0,0,0,12,0,980004
14000US06037980005,140,6,37,0,0,0,0,0,0,0,0,0,0,0,0,0,0,0,0,0,0,0,0,0,0,0,0,0,0,0,0,980005
14000US06037980006,140,6,37,0,0,0,0,0,0,0,0,0,0,0,0,0,0,0,0,0,0,0,0,0,0,0,0,0,0,0,0,980006
14000US06037980007,140,6,37,0,0,0,0,0,0,0,0,0,0,0,0,0,0,0,0,0,0,0,0,0,0,0,0,0,0,0,0,980007
14000US06037980008,140,6,37,34,14,0,0,0,0,0,0,14,0,14,0,14,0,20,11,0,11,4,7,0,9,0,0,0,0,9,0,980008
14000US06037980009,140,6,37,0,0,0,0,0,0,0,0,0,0,0,0,0,0,0,0,0,0,0,0,0,0,0,0,0,0,0,0,980009
14000US06037980010,140,6,37,63,4,0,0,0,0,0,0,4,4,0,0,0,0,59,8,0,8,8,0,0,51,18,0,0,0,33,0,980010
14000US06037980013,140,6,37,0,0,0,0,0,0,0,0,0,0,0,0,0,0,0,0,0,0,0,0,0,0,0,0,0,0,0,0,980013
14000US06037980014,140,6,37,33,0,0,0,0,0,0,0,0,0,0,0,0,0,33,0,0,0,0,0,0,33,0,9,0,9,24,0,980014
14000US06037980015,140,6,37,150,34,28,0,28,0,28,0,6,0,0,0,0,6,116,34,18,16,16,0,0,82,12,19,0,19,51,0,980015
14000US06037980018,140,6,37,0,0,0,0,0,0,0,0,0,0,0,0,0,0,0,0,0,0,0,0,0,0,0,0,0,0,0,0,980018
14000US06037980019,140,6,37,80,0,0,0,0,0,0,0,0,0,0,0,0,0,80,29,29,0,0,0,0,51,41,0,0,0,10,0,980019
14000US06037980020,140,6,37,0,0,0,0,0,0,0,0,0,0,0,0,0,0,0,0,0,0,0,0,0,0,0,0,0,0,0,0,980020
14000US06037980021,140,6,37,0,0,0,0,0,0,0,0,0,0,0,0,0,0,0,0,0,0,0,0,0,0,0,0,0,0,0,0,980021
14000US06037980022,140,6,37,0,0,0,0,0,0,0,0,0,0,0,0,0,0,0,0,0,0,0,0,0,0,0,0,0,0,0,0,980022
14000US06037980023,140,6,37,4,0,0,0,0,0,0,0,0,0,0,0,0,0,4,0,0,0,0,0,0,4,4,0,0,0,0,0,980023
14000US06037980024,140,6,37,63,0,0,0,0,0,0,0,0,0,0,0,0,0,63,31,31,0,0,0,0,32,18,0,0,0,14,0,980024
14000US06037980025,140,6,37,0,0,0,0,0,0,0,0,0,0,0,0,0,0,0,0,0,0,0,0,0,0,0,0,0,0,0,0,980025
14000US06037980026,140,6,37,12,0,0,0,0,0,0,0,0,0,0,0,0,0,12,12,0,12,0,12,0,0,0,0,0,0,0,0,980026
14000US06037980028,140,6,37,0,0,0,0,0,0,0,0,0,0,0,0,0,0,0,0,0,0,0,0,0,0,0,0,0,0,0,0,980028
14000US06037980030,140,6,37,0,0,0,0,0,0,0,0,0,0,0,0,0,0,0,0,0,0,0,0,0,0,0,0,0,0,0,0,980030
14000US06037980031,140,6,37,12,0,0,0,0,0,0,0,0,0,0,0,0,0,12,12,12,0,0,0,0,0,0,0,0,0,0,0,980031
14000US06037980033,140,6,37,0,0,0,0,0,0,0,0,0,0,0,0,0,0,0,0,0,0,0,0,0,0,0,0,0,0,0,0,980033
14000US06037990100,140,6,37,0,0,0,0,0,0,0,0,0,0,0,0,0,0,0,0,0,0,0,0,0,0,0,0,0,0,0,0,990100
14000US06037990200,140,6,37,0,0,0,0,0,0,0,0,0,0,0,0,0,0,0,0,0,0,0,0,0,0,0,0,0,0,0,0,990200
14000US06037990300,140,6,37,0,0,0,0,0,0,0,0,0,0,0,0,0,0,0,0,0,0,0,0,0,0,0,0,0,0,0,0,990300
